city,city_code,kalpi_code,num_voters,num_disqualified,final_num
אבו ג'ווייעד (שבט,967,1,66,5,61
אבו ג'ווייעד (שבט,967,2,145,1,144
אבו ג'ווייעד (שבט,967,3,102,1,101
אבו גוש,472,1,442,4,438
אבו גוש,472,2,458,3,455
אבו גוש,472,3,476,11,465
אבו גוש,472,4,425,6,419
אבו גוש,472,5,381,6,375
אבו גוש,472,6,357,3,354
אבו סנאן,473,1,493,5,488
אבו סנאן,473,2,473,7,466
אבו סנאן,473,3,469,7,462
אבו סנאן,473,4,417,5,412
אבו סנאן,473,5,537,5,532
אבו סנאן,473,6,500,2,498
אבו סנאן,473,7,491,3,488
אבו סנאן,473,8,477,8,469
אבו סנאן,473,9,519,1,518
אבו סנאן,473,10,436,3,433
אבו סנאן,473,11,500,5,495
אבו סנאן,473,12,486,1,485
אבו עבדון (שבט),958,1,37,1,36
אבו קורינאת (שבט),968,1,190,3,187
אבו קורינאת (שבט),968,2,175,0,175
אבו קורינאת (שבט),968,3,242,4,238
אבו קורינאת (שבט),968,4,152,0,152
אבו קרינאת (יישוב,1342,1,65,1,64
אבו רובייעה (שבט),966,1,161,4,157
אבו רובייעה (שבט),966,2,138,0,138
אבו רובייעה (שבט),966,3,144,4,140
אבו רובייעה (שבט),966,4,142,1,141
אבו רובייעה (שבט),966,5,131,2,129
אבו רוקייק (שבט),961,1,94,1,93
אבו רוקייק (שבט),961,2,209,0,209
אבו רוקייק (שבט),961,3,185,2,183
אבו רוקייק (שבט),961,4,207,2,205
אבו רוקייק (שבט),961,5,200,2,198
אבו רוקייק (שבט),961,6,212,1,211
אבו רוקייק (שבט),961,7,164,2,162
אבטין,652,1,234,9,225
אבטין,652,2,203,0,203
אבטין,652,3,370,6,364
אבטליון,1275,1,188,1,187
אביאל,679,1,414,1,413
אביבים,1115,1,230,2,228
אביגדור,819,1,475,0,475
אביחיל,175,1,318,0,318
אביחיל,175,2,417,3,414
אביטל,2052,1,290,2,288
אביעזר,1070,1,406,0,406
אבירים,1220,1,123,1,122
אבן יהודה,182,1,575,1,574
אבן יהודה,182,2,438,2,436
אבן יהודה,182,3,625,1,624
אבן יהודה,182,4,558,4,554
אבן יהודה,182,5,430,7,423
אבן יהודה,182,6,558,2,556
אבן יהודה,182,7,573,0,573
אבן יהודה,182,8,378,0,378
אבן יהודה,182,9,408,0,408
אבן יהודה,182,10,510,5,505
אבן יהודה,182,11,611,2,609
אבן יהודה,182,12,360,4,356
אבן יהודה,182,13,365,2,363
אבן יהודה,182,14,444,2,442
אבן יהודה,182,15,452,4,448
אבן מנחם,1081,1,199,1,198
אבן ספיר,783,1,379,0,379
אבן שמואל,400,1,522,3,519
אבני איתן,4011,1,285,0,285
אבני חפץ,3793,1,541,2,539
אבני חפץ,3793,2,194,0,194
אבשלום,1311,1,142,4,138
אדורה,3759,1,176,0,176
אדירים,113,1,163,3,160
אדמית,1068,1,160,0,160
אדרת,1123,1,383,2,381
אודים,446,1,590,2,588
אודם,4010,1,80,0,80
אוהד,1046,1,187,1,186
אום אל-פחם,2710,1,267,1,266
אום אל-פחם,2710,2,461,4,457
אום אל-פחם,2710,3,443,2,441
אום אל-פחם,2710,4,433,7,426
אום אל-פחם,2710,5,355,1,354
אום אל-פחם,2710,6,376,0,376
אום אל-פחם,2710,7,256,0,256
אום אל-פחם,2710,8,349,3,346
אום אל-פחם,2710,9,428,4,424
אום אל-פחם,2710,10,440,3,437
אום אל-פחם,2710,11,418,7,411
אום אל-פחם,2710,12,401,2,399
אום אל-פחם,2710,13,385,2,383
אום אל-פחם,2710,14,327,2,325
אום אל-פחם,2710,15,535,3,532
אום אל-פחם,2710,16,310,0,310
אום אל-פחם,2710,17,438,5,433
אום אל-פחם,2710,18,463,2,461
אום אל-פחם,2710,19,633,4,629
אום אל-פחם,2710,20,491,2,489
אום אל-פחם,2710,21,496,2,494
אום אל-פחם,2710,22,265,1,264
אום אל-פחם,2710,23,376,2,374
אום אל-פחם,2710,24,435,4,431
אום אל-פחם,2710,25,367,1,366
אום אל-פחם,2710,26,373,2,371
אום אל-פחם,2710,27,267,1,266
אום אל-פחם,2710,28,377,4,373
אום אל-פחם,2710,29,396,2,394
אום אל-פחם,2710,30,366,6,360
אום אל-פחם,2710,31,374,0,374
אום אל-פחם,2710,32,302,4,298
אום אל-פחם,2710,33,539,2,537
אום אל-פחם,2710,34,348,0,348
אום אל-פחם,2710,35,320,2,318
אום אל-פחם,2710,36,387,3,384
אום אל-פחם,2710,37,437,1,436
אום אל-פחם,2710,39,393,6,387
אום אל-פחם,2710,41,302,2,300
אום אל-פחם,2710,42,388,0,388
אום אל-פחם,2710,43,348,3,345
אום אל-פחם,2710,44,320,1,319
אום אל-פחם,2710,45,388,5,383
אום אל-פחם,2710,46,325,4,321
אום אל-פחם,2710,47,420,4,416
אום אל-פחם,2710,48,492,4,488
אום אל-פחם,2710,49,376,2,374
אום אל-פחם,2710,50,405,1,404
אום אל-פחם,2710,51,348,3,345
אום אל-פחם,2710,52,443,2,441
אום אל-פחם,2710,53,448,8,440
אום אל-פחם,2710,54,441,14,427
אום אל-קוטוף,2024,1,520,1,519
אום בטין,1358,1,287,5,282
אום בטין,1358,2,308,1,307
אומן,1108,1,177,0,177
אומץ,680,1,351,0,351
אופקים,31,1,243,0,243
אופקים,31,2,389,4,385
אופקים,31,3,308,3,305
אופקים,31,4,360,4,356
אופקים,31,5,225,8,217
אופקים,31,6,444,1,443
אופקים,31,7,333,11,322
אופקים,31,8,366,1,365
אופקים,31,9,409,10,399
אופקים,31,10,432,16,416
אופקים,31,11,437,6,431
אופקים,31,12,599,8,591
אופקים,31,13,407,3,404
אופקים,31,14,512,7,505
אופקים,31,15,434,7,427
אופקים,31,16,330,10,320
אופקים,31,17,434,5,429
אופקים,31,18,309,4,305
אופקים,31,19,402,3,399
אופקים,31,20,461,10,451
אופקים,31,21,295,2,293
אופקים,31,22,390,1,389
אופקים,31,23,305,6,299
אופקים,31,24,457,8,449
אופקים,31,25,261,6,255
אופקים,31,26,294,3,291
אופקים,31,27,223,3,220
אופקים,31,28,503,11,492
אופקים,31,30,468,3,465
אופקים,31,31,496,6,490
אופקים,31,32,327,4,323
אופקים,31,33,464,10,454
אופקים,31,34,320,0,320
אור הגנוז,1294,1,125,0,125
אור הנר,67,1,444,1,443
אור יהודה,2400,1,279,3,276
אור יהודה,2400,2,328,10,318
אור יהודה,2400,3,395,11,384
אור יהודה,2400,4,338,5,333
אור יהודה,2400,5,254,9,245
אור יהודה,2400,6,326,5,321
אור יהודה,2400,7,445,3,442
אור יהודה,2400,8,402,3,399
אור יהודה,2400,9,352,6,346
אור יהודה,2400,10,498,7,491
אור יהודה,2400,11,522,6,516
אור יהודה,2400,12,430,13,417
אור יהודה,2400,13,361,5,356
אור יהודה,2400,14,490,5,485
אור יהודה,2400,15,470,8,462
אור יהודה,2400,16,383,9,374
אור יהודה,2400,17,380,6,374
אור יהודה,2400,18,345,6,339
אור יהודה,2400,19,324,6,318
אור יהודה,2400,20,346,6,340
אור יהודה,2400,21,448,1,447
אור יהודה,2400,22,453,9,444
אור יהודה,2400,23,322,1,321
אור יהודה,2400,24,365,18,347
אור יהודה,2400,25,581,4,577
אור יהודה,2400,26,394,15,379
אור יהודה,2400,27,353,3,350
אור יהודה,2400,28,384,2,382
אור יהודה,2400,29,530,4,526
אור יהודה,2400,30,389,4,385
אור יהודה,2400,31,450,5,445
אור יהודה,2400,32,406,2,404
אור יהודה,2400,33,366,0,366
אור יהודה,2400,34,525,5,520
אור יהודה,2400,35,415,3,412
אור יהודה,2400,36,522,2,520
אור יהודה,2400,37,344,0,344
אור יהודה,2400,37,319,0,319
אור יהודה,2400,38,417,2,415
אור יהודה,2400,39,472,5,467
אור יהודה,2400,40,556,10,546
אור יהודה,2400,41,382,1,381
אור יהודה,2400,42,235,4,231
אור יהודה,2400,43,103,1,102
אור יהודה,2400,44,611,24,587
אור יהודה,2400,45,426,3,423
אור יהודה,2400,101,349,5,344
אור עקיבא,1020,1,357,1,356
אור עקיבא,1020,2,488,6,482
אור עקיבא,1020,3,478,4,474
אור עקיבא,1020,4,489,0,489
אור עקיבא,1020,5,326,5,321
אור עקיבא,1020,6,382,1,381
אור עקיבא,1020,7,306,10,296
אור עקיבא,1020,8,351,3,348
אור עקיבא,1020,9,363,3,360
אור עקיבא,1020,10,399,7,392
אור עקיבא,1020,11,359,5,354
אור עקיבא,1020,12,308,4,304
אור עקיבא,1020,15,527,5,522
אור עקיבא,1020,16,359,9,350
אור עקיבא,1020,17,376,1,375
אור עקיבא,1020,18,297,0,297
אור עקיבא,1020,19,329,2,327
אור עקיבא,1020,20,352,8,344
אור עקיבא,1020,21,375,2,373
אור עקיבא,1020,22,327,2,325
אור עקיבא,1020,23,416,3,413
אור עקיבא,1020,24,464,3,461
אור עקיבא,1020,25,316,1,315
אור עקיבא,1020,950,329,1,328
אור עקיבא,1020,950,288,0,288
אורה,780,1,379,8,371
אורה,780,2,235,0,235
אורות,2012,1,321,1,320
אורטל,4013,1,163,1,162
אורים,403,1,260,4,256
אורנית,3760,1,486,2,484
אורנית,3760,2,573,0,573
אורנית,3760,3,464,1,463
אורנית,3760,4,528,0,528
אורנית,3760,5,519,0,519
אורנית,3760,6,482,1,481
אורנית,3760,7,575,1,574
אורנית,3760,8,388,0,388
אורנית,3760,9,645,4,641
אושה,278,1,248,0,248
אזור,565,1,545,6,539
אזור,565,2,604,3,601
אזור,565,3,415,5,410
אזור,565,4,469,2,467
אזור,565,5,426,1,425
אזור,565,6,427,3,424
אזור,565,7,488,6,482
אזור,565,8,442,7,435
אזור,565,9,480,4,476
אזור,565,10,344,2,342
אזור,565,11,525,5,520
אזור,565,12,402,5,397
אזור,565,13,607,5,602
אזור,565,15,349,3,346
אחווה,1157,1,145,0,145
אחוזם,821,1,270,1,269
אחוזת ברק,1330,1,566,2,564
אחוזת ברק,1330,2,601,1,600
אחיהוד,785,1,449,3,446
אחיטוב,850,1,286,0,286
אחיטוב,850,2,259,0,259
אחיסמך,804,1,346,2,344
אחיסמך,804,2,327,3,324
אחיעזר,797,1,556,9,547
אחיעזר,797,2,301,0,301
אטרש (שבט),965,1,139,1,138
אטרש (שבט),965,2,179,5,174
אטרש (שבט),965,3,139,1,138
איבים,338,1,77,2,75
אייל,716,1,298,2,296
איילת השחר,77,1,381,5,376
איילת השחר,77,2,347,5,342
אילון,294,1,267,1,266
אילון,294,2,323,0,323
אילות,1126,1,166,1,165
אילניה,49,1,301,3,298
אילת,2600,1,168,2,166
אילת,2600,2,252,3,249
אילת,2600,3,226,9,217
אילת,2600,4,82,1,81
אילת,2600,5,287,2,285
אילת,2600,6,282,5,277
אילת,2600,7,246,3,243
אילת,2600,8,241,2,239
אילת,2600,9,358,4,354
אילת,2600,10,317,5,312
אילת,2600,11,170,0,170
אילת,2600,12,206,2,204
אילת,2600,13,188,4,184
אילת,2600,14,196,3,193
אילת,2600,15,162,2,160
אילת,2600,16,287,1,286
אילת,2600,17,71,1,70
אילת,2600,18,209,2,207
אילת,2600,19,79,2,77
אילת,2600,20,182,1,181
אילת,2600,21,204,0,204
אילת,2600,22,237,3,234
אילת,2600,23,245,4,241
אילת,2600,24,161,3,158
אילת,2600,25,168,5,163
אילת,2600,26,137,3,134
אילת,2600,27,266,4,262
אילת,2600,28,293,3,290
אילת,2600,29,393,1,392
אילת,2600,30,281,2,279
אילת,2600,31,339,4,335
אילת,2600,32,353,10,343
אילת,2600,33,92,3,89
אילת,2600,34,343,8,335
אילת,2600,35,220,4,216
אילת,2600,36,388,1,387
אילת,2600,37,224,4,220
אילת,2600,37,164,0,164
אילת,2600,38,346,6,340
אילת,2600,39,274,2,272
אילת,2600,40,338,3,335
אילת,2600,41,250,2,248
אילת,2600,42,319,0,319
אילת,2600,43,326,3,323
אילת,2600,44,244,5,239
אילת,2600,45,258,2,256
אילת,2600,46,366,1,365
אילת,2600,47,365,3,362
אילת,2600,48,420,5,415
אילת,2600,49,290,2,288
אילת,2600,50,273,2,271
אילת,2600,51,380,4,376
אילת,2600,52,221,3,218
אילת,2600,53,259,4,255
אילת,2600,54,262,3,259
אילת,2600,55,367,0,367
אילת,2600,57,235,0,235
אילת,2600,60,425,3,422
אילת,2600,61,138,0,138
אילת,2600,62,157,2,155
אילת,2600,63,181,0,181
אילת,2600,64,250,8,242
אילת,2600,65,427,1,426
אילת,2600,66,422,3,419
אילת,2600,67,400,4,396
אילת,2600,68,471,6,465
אילת,2600,69,349,4,345
אילת,2600,70,442,2,440
אילת,2600,71,176,2,174
אילת,2600,72,386,0,386
אילת,2600,73,255,2,253
אילת,2600,74,419,6,413
אילת,2600,75,441,3,438
אילת,2600,76,428,4,424
אילת,2600,77,518,2,516
אילת,2600,78,314,4,310
אילת,2600,79,418,3,415
אילת,2600,80,290,5,285
אילת,2600,81,442,1,441
אילת,2600,82,331,2,329
אילת,2600,83,474,2,472
איתמר,3762,1,398,0,398
איתן,37,1,255,1,254
אכסאל,478,1,435,6,429
אכסאל,478,2,441,2,439
אכסאל,478,3,346,1,345
אכסאל,478,4,356,1,355
אכסאל,478,5,450,5,445
אכסאל,478,6,445,5,440
אכסאל,478,7,408,1,407
אכסאל,478,8,371,2,369
אכסאל,478,9,453,1,452
אכסאל,478,10,455,1,454
אכסאל,478,11,446,6,440
אכסאל,478,12,454,3,451
אכסאל,478,13,431,4,427
אל סייד,1359,1,167,0,167
אל-עריאן,1316,1,77,1,76
אל-רום,4003,1,207,2,205
אלומה,1145,1,270,0,270
אלומות,330,1,177,0,177
אלון הגליל,1182,1,553,0,553
אלון מורה,3579,1,395,0,395
אלון מורה,3579,2,356,0,356
אלון שבות,3604,1,512,0,512
אלון שבות,3604,2,641,1,640
אלון שבות,3604,3,510,3,507
אלוני אבא,429,1,502,0,502
אלוני הבשן,4017,1,156,0,156
אלוני יצחק,868,1,27,0,27
אלונים,285,1,408,5,403
אלי-עד,4002,1,181,0,181
אליכין,41,1,403,5,398
אליכין,41,2,536,2,534
אליכין,41,3,530,5,525
אליכין,41,4,486,5,481
אליפלט,730,1,293,0,293
אליקים,682,1,432,1,431
אלישיב,204,1,388,1,387
אלישמע,841,1,301,5,296
אלישמע,841,2,325,3,322
אלמגור,1125,1,197,0,197
אלמוג,3556,1,105,1,104
אלעד,1309,1,551,1,550
אלעד,1309,2,383,10,373
אלעד,1309,3,636,6,630
אלעד,1309,4,509,31,478
אלעד,1309,5,605,5,600
אלעד,1309,6,369,9,360
אלעד,1309,7,667,17,650
אלעד,1309,8,472,2,470
אלעד,1309,9,616,14,602
אלעד,1309,10,657,11,646
אלעד,1309,11,532,3,529
אלעד,1309,12,654,2,652
אלעד,1309,13,689,4,685
אלעד,1309,14,697,0,697
אלעד,1309,15,549,13,536
אלעד,1309,16,703,15,688
אלעד,1309,17,478,4,474
אלעד,1309,18,624,10,614
אלעד,1309,19,463,3,460
אלעד,1309,20,557,8,549
אלעד,1309,21,530,6,524
אלעד,1309,22,659,13,646
אלעד,1309,23,708,4,704
אלעד,1309,24,347,6,341
אלעד,1309,25,485,28,457
אלעד,1309,26,444,0,444
אלעד,1309,27,521,3,518
אלעזר,3618,1,570,0,570
אלעזר,3618,2,538,1,537
אלפי מנשה,3750,1,588,0,588
אלפי מנשה,3750,2,312,1,311
אלפי מנשה,3750,3,526,1,525
אלפי מנשה,3750,4,414,1,413
אלפי מנשה,3750,5,542,2,540
אלפי מנשה,3750,6,614,3,611
אלפי מנשה,3750,7,399,0,399
אלפי מנשה,3750,8,493,4,489
אלפי מנשה,3750,9,361,0,361
אלקוש,603,1,174,3,171
אלקנה,3560,1,669,2,667
אלקנה,3560,2,552,1,551
אלקנה,3560,3,393,1,392
אלקנה,3560,4,486,2,484
אמונים,772,1,476,4,472
אמירים,1064,1,384,2,382
אמנון,1253,1,168,1,167
אמציה,23,1,254,0,254
אניעם,4012,1,282,3,279
אסד (שבט),960,1,67,1,66
אספר,3754,1,187,2,185
אעבלין,529,1,443,4,439
אעבלין,529,2,356,0,356
אעבלין,529,3,404,9,395
אעבלין,529,4,466,5,461
אעבלין,529,5,394,5,389
אעבלין,529,6,445,1,444
אעבלין,529,7,390,5,385
אעבלין,529,8,432,1,431
אעבלין,529,9,361,0,361
אעבלין,529,10,391,2,389
אעבלין,529,11,341,4,337
אעבלין,529,12,487,3,484
אעצם (שבט),963,1,200,2,198
אעצם (שבט),963,2,309,4,305
אעצם (שבט),963,3,162,8,154
אעצם (שבט),963,4,216,8,208
אעצם (שבט),963,5,230,3,227
אעצם (שבט),963,6,214,0,214
אפיק,4301,1,217,1,216
אפיקים,176,1,334,4,330
אפיקים,176,2,395,3,392
אפק,313,1,305,0,305
אפרת,3650,1,496,5,491
אפרת,3650,2,559,0,559
אפרת,3650,3,575,2,573
אפרת,3650,4,514,3,511
אפרת,3650,5,505,3,502
אפרת,3650,6,559,0,559
אפרת,3650,7,492,0,492
אפרת,3650,8,432,0,432
אפרת,3650,9,451,1,450
ארבל,701,1,317,3,314
ארגמן,3598,1,88,1,87
ארז,714,1,305,3,302
אריאל,3570,1,470,4,466
אריאל,3570,2,425,3,422
אריאל,3570,3,297,7,290
אריאל,3570,4,397,8,389
אריאל,3570,5,472,6,466
אריאל,3570,6,510,9,501
אריאל,3570,7,411,4,407
אריאל,3570,8,454,11,443
אריאל,3570,9,270,3,267
אריאל,3570,9,222,1,221
אריאל,3570,10,419,7,412
אריאל,3570,11,481,14,467
אריאל,3570,12,489,8,481
אריאל,3570,13,384,6,378
אריאל,3570,14,374,7,367
אריאל,3570,15,597,6,591
אריאל,3570,16,404,10,394
אריאל,3570,17,449,3,446
אריאל,3570,18,372,5,367
אריאל,3570,20,317,3,314
אריאל,3570,21,311,5,306
אריאל,3570,22,309,5,304
אריאל,3570,23,360,13,347
אריאל,3570,24,326,4,322
אריאל,3570,25,356,7,349
אשבול,71,1,227,2,225
אשדוד,70,1,294,11,283
אשדוד,70,2,399,6,393
אשדוד,70,3,350,7,343
אשדוד,70,4,287,5,282
אשדוד,70,5,382,9,373
אשדוד,70,6,336,8,328
אשדוד,70,7,295,6,289
אשדוד,70,8,180,6,174
אשדוד,70,9,338,10,328
אשדוד,70,10,251,5,246
אשדוד,70,11,322,6,316
אשדוד,70,12,240,6,234
אשדוד,70,13,308,10,298
אשדוד,70,14,259,3,256
אשדוד,70,15,335,6,329
אשדוד,70,16,306,10,296
אשדוד,70,17,325,12,313
אשדוד,70,18,319,9,310
אשדוד,70,19,322,6,316
אשדוד,70,20,351,7,344
אשדוד,70,21,376,6,370
אשדוד,70,22,255,2,253
אשדוד,70,23,369,11,358
אשדוד,70,24,410,7,403
אשדוד,70,25,286,12,274
אשדוד,70,26,383,18,365
אשדוד,70,27,424,2,422
אשדוד,70,28,256,2,254
אשדוד,70,29,338,5,333
אשדוד,70,30,475,13,462
אשדוד,70,31,297,13,284
אשדוד,70,32,650,17,633
אשדוד,70,33,396,11,385
אשדוד,70,34,374,8,366
אשדוד,70,35,326,11,315
אשדוד,70,36,387,6,381
אשדוד,70,37,320,4,316
אשדוד,70,38,249,7,242
אשדוד,70,39,282,6,276
אשדוד,70,40,229,4,225
אשדוד,70,41,261,2,259
אשדוד,70,42,246,6,240
אשדוד,70,43,257,10,247
אשדוד,70,44,509,9,500
אשדוד,70,45,366,3,363
אשדוד,70,46,327,8,319
אשדוד,70,47,363,5,358
אשדוד,70,48,292,8,284
אשדוד,70,49,436,14,422
אשדוד,70,50,291,8,283
אשדוד,70,51,442,9,433
אשדוד,70,52,348,8,340
אשדוד,70,53,524,7,517
אשדוד,70,54,337,6,331
אשדוד,70,55,406,14,392
אשדוד,70,56,474,4,470
אשדוד,70,57,414,3,411
אשדוד,70,58,420,18,402
אשדוד,70,59,360,25,335
אשדוד,70,60,492,52,440
אשדוד,70,61,263,7,256
אשדוד,70,62,332,35,297
אשדוד,70,63,391,15,376
אשדוד,70,64,482,6,476
אשדוד,70,65,316,5,311
אשדוד,70,66,417,2,415
אשדוד,70,67,360,8,352
אשדוד,70,68,411,8,403
אשדוד,70,69,432,20,412
אשדוד,70,70,323,11,312
אשדוד,70,71,279,4,275
אשדוד,70,72,269,8,261
אשדוד,70,73,303,11,292
אשדוד,70,74,338,5,333
אשדוד,70,75,386,7,379
אשדוד,70,76,426,5,421
אשדוד,70,77,346,4,342
אשדוד,70,79,387,4,383
אשדוד,70,80,221,0,221
אשדוד,70,81,440,6,434
אשדוד,70,82,339,2,337
אשדוד,70,83,406,9,397
אשדוד,70,84,386,7,379
אשדוד,70,85,458,6,452
אשדוד,70,86,414,5,409
אשדוד,70,87,352,4,348
אשדוד,70,88,341,19,322
אשדוד,70,89,344,0,344
אשדוד,70,90,290,3,287
אשדוד,70,91,340,10,330
אשדוד,70,92,420,0,420
אשדוד,70,93,350,3,347
אשדוד,70,94,330,8,322
אשדוד,70,95,323,8,315
אשדוד,70,96,427,6,421
אשדוד,70,97,402,4,398
אשדוד,70,98,424,7,417
אשדוד,70,99,417,10,407
אשדוד,70,100,392,8,384
אשדוד,70,101,437,13,424
אשדוד,70,102,363,5,358
אשדוד,70,103,449,1,448
אשדוד,70,104,327,8,319
אשדוד,70,105,426,4,422
אשדוד,70,106,419,2,417
אשדוד,70,107,420,1,419
אשדוד,70,108,478,10,468
אשדוד,70,109,316,1,315
אשדוד,70,110,394,3,391
אשדוד,70,111,488,7,481
אשדוד,70,112,287,5,282
אשדוד,70,113,387,2,385
אשדוד,70,114,312,3,309
אשדוד,70,115,590,4,586
אשדוד,70,116,311,3,308
אשדוד,70,117,455,4,451
אשדוד,70,118,441,4,437
אשדוד,70,119,361,7,354
אשדוד,70,120,373,4,369
אשדוד,70,121,485,5,480
אשדוד,70,122,579,0,579
אשדוד,70,123,564,0,564
אשדוד,70,124,361,10,351
אשדוד,70,125,376,11,365
אשדוד,70,126,560,6,554
אשדוד,70,127,565,3,562
אשדוד,70,128,448,13,435
אשדוד,70,129,577,6,571
אשדוד,70,130,341,8,333
אשדוד,70,131,412,8,404
אשדוד,70,132,439,11,428
אשדוד,70,133,308,4,304
אשדוד,70,134,301,4,297
אשדוד,70,135,424,8,416
אשדוד,70,136,509,12,497
אשדוד,70,137,382,10,372
אשדוד,70,138,391,4,387
אשדוד,70,139,411,3,408
אשדוד,70,140,438,10,428
אשדוד,70,141,692,23,669
אשדוד,70,142,429,5,424
אשדוד,70,143,392,5,387
אשדוד,70,144,455,12,443
אשדוד,70,145,411,7,404
אשדוד,70,146,403,8,395
אשדוד,70,147,478,18,460
אשדוד,70,148,481,11,470
אשדוד,70,149,497,2,495
אשדוד,70,150,484,7,477
אשדוד,70,151,329,6,323
אשדוד,70,152,459,5,454
אשדוד,70,153,327,8,319
אשדוד,70,154,506,1,505
אשדוד,70,155,362,1,361
אשדוד,70,156,323,4,319
אשדוד,70,157,461,9,452
אשדוד,70,158,464,7,457
אשדוד,70,159,360,7,353
אשדוד,70,160,419,11,408
אשדוד,70,161,336,7,329
אשדוד,70,162,453,4,449
אשדוד,70,163,458,8,450
אשדוד,70,164,439,10,429
אשדוד,70,165,443,3,440
אשדוד,70,166,441,5,436
אשדוד,70,167,541,13,528
אשדוד,70,168,471,3,468
אשדוד,70,169,389,0,389
אשדוד,70,170,360,6,354
אשדוד,70,171,380,6,374
אשדוד,70,172,408,5,403
אשדוד,70,173,457,11,446
אשדוד,70,174,385,1,384
אשדוד,70,175,377,5,372
אשדוד,70,176,561,8,553
אשדוד,70,177,396,2,394
אשדוד,70,178,384,3,381
אשדוד,70,179,457,2,455
אשדוד,70,180,591,18,573
אשדוד,70,181,530,16,514
אשדוד,70,182,556,7,549
אשדוד,70,183,607,7,600
אשדוד,70,184,424,0,424
אשדוד,70,185,594,4,590
אשדוד,70,186,612,6,606
אשדוד,70,187,593,12,581
אשדוד,70,188,453,5,448
אשדוד,70,189,367,9,358
אשדוד,70,190,388,9,379
אשדוד,70,191,529,5,524
אשדוד,70,192,432,5,427
אשדוד,70,193,349,8,341
אשדוד,70,194,541,7,534
אשדוד,70,195,692,11,681
אשדוד,70,196,444,10,434
אשדוד,70,197,517,12,505
אשדוד,70,198,557,6,551
אשדוד,70,199,342,2,340
אשדוד,70,200,432,2,430
אשדוד,70,201,488,4,484
אשדוד,70,202,501,7,494
אשדוד,70,203,532,3,529
אשדוד,70,204,512,5,507
אשדוד,70,205,474,6,468
אשדוד,70,206,309,5,304
אשדוד,70,207,331,3,328
אשדוד,70,208,346,10,336
אשדוד,70,209,305,13,292
אשדוד,70,210,303,12,291
אשדוד,70,211,428,6,422
אשדוד,70,212,612,13,599
אשדוד,70,213,357,12,345
אשדוד,70,214,368,6,362
אשדוד,70,215,299,2,297
אשדוד,70,216,528,9,519
אשדוד,70,217,538,10,528
אשדוד,70,218,449,4,445
אשדוד,70,219,540,4,536
אשדוד,70,220,357,3,354
אשדוד,70,221,430,4,426
אשדוד,70,222,462,0,462
אשדוד,70,223,358,1,357
אשדוד,70,224,477,6,471
אשדוד,70,225,483,8,475
אשדוד,70,226,467,6,461
אשדוד,70,227,490,11,479
אשדוד,70,228,340,1,339
אשדוד,70,229,426,7,419
אשדוד,70,230,516,4,512
אשדוד,70,231,452,3,449
אשדוד,70,232,332,5,327
אשדוד,70,233,347,2,345
אשדוד,70,234,472,8,464
אשדוד,70,235,482,7,475
אשדוד,70,236,427,5,422
אשדוד,70,237,417,5,412
אשדוד,70,238,481,3,478
אשדוד,70,239,371,1,370
אשדוד,70,240,564,5,559
אשדוד,70,241,509,0,509
אשדוד,70,242,596,2,594
אשדוד,70,243,515,3,512
אשדוד,70,244,559,8,551
אשדוד,70,245,524,3,521
אשדוד,70,246,659,0,659
אשדוד,70,247,390,4,386
אשדוד,70,248,192,0,192
אשדוד,70,249,500,22,478
אשדוד,70,250,239,3,236
אשדוד,70,251,368,4,364
אשדוד,70,252,376,6,370
אשדוד,70,253,494,44,450
אשדוד,70,254,396,5,391
אשדוד,70,255,326,3,323
אשדוד,70,256,306,4,302
אשדוד,70,258,218,4,214
אשדוד,70,260,635,10,625
אשדוד,70,261,345,5,340
אשדוד,70,262,317,4,313
אשדוד,70,264,334,6,328
אשדוד,70,265,552,8,544
אשדוד,70,266,232,0,232
אשדוד,70,270,305,2,303
אשדוד,70,272,501,12,489
אשדוד,70,273,514,1,513
אשדוד,70,274,326,9,317
אשדוד,70,275,417,4,413
אשדוד,70,276,434,4,430
אשדוד,70,277,562,0,562
אשדוד,70,278,425,3,422
אשדוד,70,279,273,0,273
אשדוד,70,280,349,3,346
אשדוד,70,281,604,5,599
אשדוד,70,282,538,8,530
אשדוד,70,283,307,0,307
אשדוד,70,285,222,8,214
אשדוד,70,286,629,20,609
אשדוד,70,287,401,4,397
אשדוד,70,952,403,1,402
אשדוד,70,953,521,5,516
אשדוד,70,954,567,3,564
אשדוד,70,955,448,4,444
אשדות יעקב  (איחו,199,1,449,1,448
אשדות יעקב  (מאוח,188,1,296,0,296
אשחר,1188,1,382,2,380
אשכולות,3722,1,166,1,165
אשל הנשיא,2021,1,59,0,59
אשלים,1152,1,227,0,227
אשקלון,7100,1,322,20,302
אשקלון,7100,2,321,3,318
אשקלון,7100,3,441,14,427
אשקלון,7100,4,393,5,388
אשקלון,7100,5,434,2,432
אשקלון,7100,6,386,4,382
אשקלון,7100,7,293,5,288
אשקלון,7100,8,459,7,452
אשקלון,7100,9,339,7,332
אשקלון,7100,10,326,10,316
אשקלון,7100,11,526,21,505
אשקלון,7100,12,544,20,524
אשקלון,7100,13,394,4,390
אשקלון,7100,14,356,6,350
אשקלון,7100,15,415,0,415
אשקלון,7100,16,314,6,308
אשקלון,7100,17,402,7,395
אשקלון,7100,18,446,6,440
אשקלון,7100,19,477,6,471
אשקלון,7100,20,483,6,477
אשקלון,7100,21,377,4,373
אשקלון,7100,22,488,13,475
אשקלון,7100,23,381,11,370
אשקלון,7100,24,350,12,338
אשקלון,7100,25,345,3,342
אשקלון,7100,26,264,9,255
אשקלון,7100,27,252,12,240
אשקלון,7100,28,218,4,214
אשקלון,7100,29,327,0,327
אשקלון,7100,30,259,6,253
אשקלון,7100,31,442,9,433
אשקלון,7100,32,283,4,279
אשקלון,7100,33,335,8,327
אשקלון,7100,34,288,7,281
אשקלון,7100,35,283,3,280
אשקלון,7100,36,331,1,330
אשקלון,7100,37,300,7,293
אשקלון,7100,38,268,10,258
אשקלון,7100,39,347,11,336
אשקלון,7100,40,399,3,396
אשקלון,7100,41,489,4,485
אשקלון,7100,42,446,2,444
אשקלון,7100,43,440,1,439
אשקלון,7100,44,427,2,425
אשקלון,7100,45,444,2,442
אשקלון,7100,46,480,4,476
אשקלון,7100,47,412,3,409
אשקלון,7100,48,474,1,473
אשקלון,7100,49,295,7,288
אשקלון,7100,50,449,4,445
אשקלון,7100,51,250,0,250
אשקלון,7100,52,374,1,373
אשקלון,7100,53,337,3,334
אשקלון,7100,54,270,5,265
אשקלון,7100,55,324,11,313
אשקלון,7100,56,461,9,452
אשקלון,7100,57,368,1,367
אשקלון,7100,58,354,3,351
אשקלון,7100,59,337,11,326
אשקלון,7100,60,330,3,327
אשקלון,7100,61,233,7,226
אשקלון,7100,62,374,6,368
אשקלון,7100,63,343,3,340
אשקלון,7100,64,377,13,364
אשקלון,7100,65,318,4,314
אשקלון,7100,66,402,10,392
אשקלון,7100,67,396,9,387
אשקלון,7100,68,365,10,355
אשקלון,7100,69,551,4,547
אשקלון,7100,70,490,2,488
אשקלון,7100,71,421,3,418
אשקלון,7100,72,447,8,439
אשקלון,7100,73,381,12,369
אשקלון,7100,74,469,7,462
אשקלון,7100,75,489,3,486
אשקלון,7100,76,327,1,326
אשקלון,7100,77,372,0,372
אשקלון,7100,78,308,2,306
אשקלון,7100,79,375,3,372
אשקלון,7100,80,340,3,337
אשקלון,7100,81,323,11,312
אשקלון,7100,82,318,10,308
אשקלון,7100,83,314,8,306
אשקלון,7100,84,338,4,334
אשקלון,7100,85,316,10,306
אשקלון,7100,86,253,11,242
אשקלון,7100,87,301,5,296
אשקלון,7100,88,266,3,263
אשקלון,7100,89,407,14,393
אשקלון,7100,90,362,11,351
אשקלון,7100,91,332,7,325
אשקלון,7100,92,309,5,304
אשקלון,7100,93,281,5,276
אשקלון,7100,94,387,11,376
אשקלון,7100,95,369,8,361
אשקלון,7100,96,452,18,434
אשקלון,7100,97,453,10,443
אשקלון,7100,98,400,8,392
אשקלון,7100,99,548,0,548
אשקלון,7100,100,492,1,491
אשקלון,7100,101,427,0,427
אשקלון,7100,102,256,2,254
אשקלון,7100,103,337,1,336
אשקלון,7100,103,311,1,310
אשקלון,7100,104,471,6,465
אשקלון,7100,105,423,10,413
אשקלון,7100,106,458,8,450
אשקלון,7100,107,462,9,453
אשקלון,7100,108,456,7,449
אשקלון,7100,109,346,14,332
אשקלון,7100,110,291,3,288
אשקלון,7100,111,359,7,352
אשקלון,7100,112,393,11,382
אשקלון,7100,113,391,5,386
אשקלון,7100,114,512,6,506
אשקלון,7100,115,524,2,522
אשקלון,7100,116,431,4,427
אשקלון,7100,117,527,4,523
אשקלון,7100,118,481,7,474
אשקלון,7100,119,553,6,547
אשקלון,7100,120,390,0,390
אשקלון,7100,121,569,4,565
אשקלון,7100,123,421,4,417
אשקלון,7100,124,445,7,438
אשקלון,7100,125,314,5,309
אשקלון,7100,126,484,3,481
אשקלון,7100,127,275,8,267
אשקלון,7100,128,303,6,297
אשקלון,7100,129,406,2,404
אשקלון,7100,130,494,8,486
אשקלון,7100,131,414,6,408
אשקלון,7100,132,384,2,382
אשקלון,7100,133,353,5,348
אשקלון,7100,134,355,3,352
אשקלון,7100,135,368,1,367
אשקלון,7100,136,307,1,306
אשקלון,7100,137,403,4,399
אשקלון,7100,138,375,7,368
אשקלון,7100,139,448,8,440
אשקלון,7100,140,304,2,302
אשקלון,7100,141,240,7,233
אשקלון,7100,142,455,3,452
אשקלון,7100,143,518,1,517
אשקלון,7100,144,517,8,509
אשקלון,7100,145,468,1,467
אשקלון,7100,146,524,6,518
אשקלון,7100,147,618,4,614
אשקלון,7100,148,389,2,387
אשקלון,7100,149,342,4,338
אשקלון,7100,150,537,6,531
אשקלון,7100,151,433,2,431
אשקלון,7100,152,430,3,427
אשקלון,7100,153,447,3,444
אשקלון,7100,154,380,7,373
אשקלון,7100,155,372,7,365
אשקלון,7100,156,432,3,429
אשקלון,7100,157,238,1,237
אשקלון,7100,158,523,1,522
אשקלון,7100,159,492,2,490
אשקלון,7100,161,384,1,383
אשקלון,7100,162,501,8,493
אשקלון,7100,163,519,5,514
אשקלון,7100,164,489,1,488
אשקלון,7100,165,559,0,559
אשקלון,7100,166,392,1,391
אשקלון,7100,952,473,8,465
אשרת,1256,1,287,0,287
אשתאול,740,1,550,2,548
באקה אל-גרביה,6000,1,491,5,486
באקה אל-גרביה,6000,2,418,0,418
באקה אל-גרביה,6000,3,443,7,436
באקה אל-גרביה,6000,4,430,5,425
באקה אל-גרביה,6000,5,414,6,408
באקה אל-גרביה,6000,6,519,4,515
באקה אל-גרביה,6000,7,416,2,414
באקה אל-גרביה,6000,8,388,0,388
באקה אל-גרביה,6000,9,406,4,402
באקה אל-גרביה,6000,10,345,1,344
באקה אל-גרביה,6000,11,387,5,382
באקה אל-גרביה,6000,12,430,4,426
באקה אל-גרביה,6000,13,386,0,386
באקה אל-גרביה,6000,14,453,3,450
באקה אל-גרביה,6000,15,406,0,406
באקה אל-גרביה,6000,16,493,1,492
באקה אל-גרביה,6000,17,442,2,440
באקה אל-גרביה,6000,18,402,5,397
באקה אל-גרביה,6000,19,429,2,427
באקה אל-גרביה,6000,20,421,1,420
באקה אל-גרביה,6000,21,331,3,328
באקה אל-גרביה,6000,22,466,6,460
באקה אל-גרביה,6000,23,347,3,344
באקה אל-גרביה,6000,24,431,3,428
באר אורה,21,1,228,2,226
באר גנים,1376,1,101,0,101
באר טוביה,155,1,541,0,541
באר יעקב,2530,1,468,3,465
באר יעקב,2530,2,490,12,478
באר יעקב,2530,3,320,2,318
באר יעקב,2530,4,343,2,341
באר יעקב,2530,5,224,2,222
באר יעקב,2530,6,454,4,450
באר יעקב,2530,7,421,4,417
באר יעקב,2530,8,576,7,569
באר יעקב,2530,9,426,15,411
באר יעקב,2530,10,352,3,349
באר יעקב,2530,11,357,2,355
באר יעקב,2530,12,401,4,397
באר יעקב,2530,13,526,3,523
באר יעקב,2530,14,498,4,494
באר יעקב,2530,15,359,1,358
באר יעקב,2530,16,599,3,596
באר יעקב,2530,17,490,3,487
באר יעקב,2530,18,607,1,606
באר יעקב,2530,19,607,3,604
באר שבע,9000,1,251,3,248
באר שבע,9000,2,259,6,253
באר שבע,9000,3,276,13,263
באר שבע,9000,4,303,0,303
באר שבע,9000,5,209,7,202
באר שבע,9000,6,270,6,264
באר שבע,9000,7,304,9,295
באר שבע,9000,9,299,5,294
באר שבע,9000,10,238,1,237
באר שבע,9000,11,369,7,362
באר שבע,9000,13,206,5,201
באר שבע,9000,14,243,2,241
באר שבע,9000,15,219,3,216
באר שבע,9000,16,230,4,226
באר שבע,9000,17,374,8,366
באר שבע,9000,18,262,3,259
באר שבע,9000,19,266,8,258
באר שבע,9000,20,201,7,194
באר שבע,9000,21,370,2,368
באר שבע,9000,22,126,1,125
באר שבע,9000,22,126,2,124
באר שבע,9000,25,219,5,214
באר שבע,9000,26,240,11,229
באר שבע,9000,27,221,5,216
באר שבע,9000,28,237,6,231
באר שבע,9000,29,242,3,239
באר שבע,9000,30,232,9,223
באר שבע,9000,31,251,3,248
באר שבע,9000,34,227,2,225
באר שבע,9000,35,342,2,340
באר שבע,9000,36,395,1,394
באר שבע,9000,37,351,4,347
באר שבע,9000,38,418,4,414
באר שבע,9000,39,298,13,285
באר שבע,9000,40,269,6,263
באר שבע,9000,42,451,6,445
באר שבע,9000,43,504,8,496
באר שבע,9000,44,258,3,255
באר שבע,9000,45,327,1,326
באר שבע,9000,46,333,2,331
באר שבע,9000,47,219,5,214
באר שבע,9000,48,437,17,420
באר שבע,9000,49,220,7,213
באר שבע,9000,53,502,2,500
באר שבע,9000,54,312,8,304
באר שבע,9000,55,293,3,290
באר שבע,9000,56,381,3,378
באר שבע,9000,57,604,7,597
באר שבע,9000,58,245,3,242
באר שבע,9000,59,419,8,411
באר שבע,9000,60,298,1,297
באר שבע,9000,62,306,2,304
באר שבע,9000,65,146,4,142
באר שבע,9000,65,136,3,133
באר שבע,9000,66,443,3,440
באר שבע,9000,68,194,4,190
באר שבע,9000,69,319,2,317
באר שבע,9000,70,297,11,286
באר שבע,9000,71,227,5,222
באר שבע,9000,73,295,2,293
באר שבע,9000,75,297,4,293
באר שבע,9000,76,225,8,217
באר שבע,9000,78,324,9,315
באר שבע,9000,79,229,4,225
באר שבע,9000,81,238,2,236
באר שבע,9000,82,227,7,220
באר שבע,9000,84,251,4,247
באר שבע,9000,86,217,2,215
באר שבע,9000,87,361,7,354
באר שבע,9000,90,263,3,260
באר שבע,9000,91,321,5,316
באר שבע,9000,92,395,4,391
באר שבע,9000,93,282,9,273
באר שבע,9000,94,302,6,296
באר שבע,9000,95,265,7,258
באר שבע,9000,96,267,5,262
באר שבע,9000,97,357,4,353
באר שבע,9000,99,387,6,381
באר שבע,9000,100,273,2,271
באר שבע,9000,101,290,2,288
באר שבע,9000,102,269,4,265
באר שבע,9000,103,262,7,255
באר שבע,9000,104,342,4,338
באר שבע,9000,105,471,3,468
באר שבע,9000,106,391,3,388
באר שבע,9000,107,499,8,491
באר שבע,9000,108,303,4,299
באר שבע,9000,109,310,7,303
באר שבע,9000,110,312,7,305
באר שבע,9000,111,279,1,278
באר שבע,9000,112,383,2,381
באר שבע,9000,113,317,3,314
באר שבע,9000,114,338,10,328
באר שבע,9000,115,453,1,452
באר שבע,9000,116,367,6,361
באר שבע,9000,117,212,3,209
באר שבע,9000,118,338,4,334
באר שבע,9000,119,337,3,334
באר שבע,9000,120,259,2,257
באר שבע,9000,121,404,9,395
באר שבע,9000,122,472,9,463
באר שבע,9000,123,321,2,319
באר שבע,9000,124,339,4,335
באר שבע,9000,125,284,3,281
באר שבע,9000,126,388,16,372
באר שבע,9000,127,364,4,360
באר שבע,9000,128,506,7,499
באר שבע,9000,129,309,3,306
באר שבע,9000,130,200,7,193
באר שבע,9000,131,602,3,599
באר שבע,9000,132,295,12,283
באר שבע,9000,134,421,27,394
באר שבע,9000,136,292,13,279
באר שבע,9000,137,226,10,216
באר שבע,9000,138,494,8,486
באר שבע,9000,139,469,1,468
באר שבע,9000,140,388,2,386
באר שבע,9000,141,265,9,256
באר שבע,9000,142,453,0,453
באר שבע,9000,143,200,1,199
באר שבע,9000,143,131,3,128
באר שבע,9000,144,194,3,191
באר שבע,9000,145,381,1,380
באר שבע,9000,146,298,4,294
באר שבע,9000,147,411,13,398
באר שבע,9000,148,350,6,344
באר שבע,9000,149,410,1,409
באר שבע,9000,150,379,0,379
באר שבע,9000,151,254,8,246
באר שבע,9000,152,273,4,269
באר שבע,9000,153,330,8,322
באר שבע,9000,154,189,9,180
באר שבע,9000,154,172,5,167
באר שבע,9000,155,320,10,310
באר שבע,9000,156,317,9,308
באר שבע,9000,157,324,6,318
באר שבע,9000,158,252,12,240
באר שבע,9000,159,255,4,251
באר שבע,9000,160,434,3,431
באר שבע,9000,161,298,5,293
באר שבע,9000,162,343,9,334
באר שבע,9000,163,350,4,346
באר שבע,9000,164,337,0,337
באר שבע,9000,165,248,6,242
באר שבע,9000,166,389,4,385
באר שבע,9000,167,347,5,342
באר שבע,9000,168,274,6,268
באר שבע,9000,169,438,6,432
באר שבע,9000,170,426,6,420
באר שבע,9000,171,409,3,406
באר שבע,9000,172,266,2,264
באר שבע,9000,173,360,3,357
באר שבע,9000,174,371,11,360
באר שבע,9000,175,401,4,397
באר שבע,9000,176,391,5,386
באר שבע,9000,177,592,5,587
באר שבע,9000,178,389,10,379
באר שבע,9000,179,465,5,460
באר שבע,9000,180,418,5,413
באר שבע,9000,181,458,5,453
באר שבע,9000,182,441,2,439
באר שבע,9000,183,486,6,480
באר שבע,9000,184,481,1,480
באר שבע,9000,185,419,0,419
באר שבע,9000,186,446,10,436
באר שבע,9000,187,481,2,479
באר שבע,9000,188,429,6,423
באר שבע,9000,189,417,10,407
באר שבע,9000,190,379,0,379
באר שבע,9000,191,549,6,543
באר שבע,9000,192,377,5,372
באר שבע,9000,193,474,5,469
באר שבע,9000,194,435,8,427
באר שבע,9000,195,547,2,545
באר שבע,9000,196,387,3,384
באר שבע,9000,197,248,2,246
באר שבע,9000,198,520,1,519
באר שבע,9000,199,400,14,386
באר שבע,9000,200,368,6,362
באר שבע,9000,201,401,3,398
באר שבע,9000,202,464,3,461
באר שבע,9000,203,416,5,411
באר שבע,9000,204,450,2,448
באר שבע,9000,205,423,3,420
באר שבע,9000,206,552,0,552
באר שבע,9000,207,421,1,420
באר שבע,9000,208,428,2,426
באר שבע,9000,209,303,8,295
באר שבע,9000,210,282,3,279
באר שבע,9000,211,445,0,445
באר שבע,9000,212,370,7,363
באר שבע,9000,213,371,7,364
באר שבע,9000,214,280,2,278
באר שבע,9000,215,390,10,380
באר שבע,9000,216,297,7,290
באר שבע,9000,217,592,4,588
באר שבע,9000,218,487,8,479
באר שבע,9000,219,317,3,314
באר שבע,9000,220,470,5,465
באר שבע,9000,221,484,3,481
באר שבע,9000,222,522,1,521
באר שבע,9000,223,435,3,432
באר שבע,9000,224,531,8,523
באר שבע,9000,225,413,2,411
באר שבע,9000,226,564,3,561
באר שבע,9000,227,442,10,432
באר שבע,9000,228,261,6,255
באר שבע,9000,229,506,5,501
באר שבע,9000,230,438,7,431
באר שבע,9000,231,408,5,403
באר שבע,9000,232,460,0,460
באר שבע,9000,233,436,5,431
באר שבע,9000,234,413,7,406
באר שבע,9000,235,262,10,252
באר שבע,9000,236,504,4,500
באר שבע,9000,237,465,3,462
באר שבע,9000,238,497,11,486
באר שבע,9000,239,410,4,406
באר שבע,9000,240,381,6,375
באר שבע,9000,241,342,2,340
באר שבע,9000,242,298,2,296
באר שבע,9000,243,356,7,349
באר שבע,9000,244,369,5,364
באר שבע,9000,245,342,2,340
באר שבע,9000,246,540,5,535
באר שבע,9000,247,318,5,313
באר שבע,9000,248,429,11,418
באר שבע,9000,249,366,3,363
באר שבע,9000,250,447,2,445
באר שבע,9000,251,435,5,430
באר שבע,9000,252,509,9,500
באר שבע,9000,253,266,2,264
באר שבע,9000,254,392,8,384
באר שבע,9000,255,598,3,595
באר שבע,9000,256,403,0,403
באר שבע,9000,257,273,5,268
באר שבע,9000,258,387,7,380
באר שבע,9000,259,499,1,498
באר שבע,9000,260,369,2,367
באר שבע,9000,261,580,3,577
באר שבע,9000,262,601,4,597
באר שבע,9000,263,595,21,574
באר שבע,9000,264,509,3,506
באר שבע,9000,265,362,1,361
באר שבע,9000,266,556,0,556
באר שבע,9000,267,548,2,546
באר שבע,9000,268,560,0,560
באר שבע,9000,269,467,8,459
באר שבע,9000,270,418,2,416
באר שבע,9000,271,545,3,542
באר שבע,9000,272,446,2,444
באר שבע,9000,273,610,8,602
באר שבע,9000,274,398,9,389
באר שבע,9000,275,430,0,430
באר שבע,9000,276,338,1,337
באר שבע,9000,277,384,5,379
באר שבע,9000,279,325,4,321
באר שבע,9000,280,387,4,383
באר שבע,9000,281,370,4,366
באר שבע,9000,285,489,1,488
באר שבע,9000,286,504,2,502
באר שבע,9000,287,349,8,341
באר שבע,9000,288,494,8,486
באר שבע,9000,290,359,14,345
באר שבע,9000,291,546,4,542
באר שבע,9000,292,543,8,535
באר שבע,9000,293,514,7,507
באר שבע,9000,294,444,5,439
באר שבע,9000,295,563,4,559
בארות יצחק,450,1,280,2,278
בארותיים,697,1,538,2,536
בארי,399,1,326,1,325
בארי,399,2,343,1,342
בוסתן הגליל,559,1,403,1,402
בועיינה-נוג'ידאת,482,1,537,5,532
בועיינה-נוג'ידאת,482,2,461,6,455
בועיינה-נוג'ידאת,482,3,400,4,396
בועיינה-נוג'ידאת,482,4,451,3,448
בועיינה-נוג'ידאת,482,5,421,5,416
בועיינה-נוג'ידאת,482,6,494,1,493
בועיינה-נוג'ידאת,482,7,435,6,429
בועיינה-נוג'ידאת,482,8,451,13,438
בוקעאתא,4001,1,17,0,17
בורגתה,698,1,368,4,364
בורגתה,698,2,260,0,260
בחן,2043,1,418,0,418
בטחה,762,1,438,1,437
ביצרון,234,1,356,1,355
ביצרון,234,2,314,3,311
ביר אל-מכסור,998,1,352,7,345
ביר אל-מכסור,998,2,428,5,423
ביר אל-מכסור,998,3,349,6,343
ביר אל-מכסור,998,4,322,4,318
ביר אל-מכסור,998,5,363,3,360
ביר אל-מכסור,998,6,319,2,317
ביר אל-מכסור,998,7,290,6,284
ביר אל-מכסור,998,8,294,12,282
ביר הדאג',1348,1,406,7,399
ביריה,368,1,434,4,430
בית אורן,317,1,193,0,193
בית אל,3574,1,537,2,535
בית אל,3574,2,630,1,629
בית אל,3574,3,502,1,501
בית אל,3574,4,576,0,576
בית אל,3574,5,485,0,485
בית אלעזרי,562,1,391,0,391
בית אלעזרי,562,2,409,2,407
בית אלפא,95,1,215,2,213
בית אלפא,95,2,280,4,276
בית אריה,3652,1,426,1,425
בית אריה,3652,2,417,0,417
בית אריה,3652,3,596,7,589
בית אריה,3652,4,497,1,496
בית אריה,3652,101,493,16,477
בית ג'ן,480,1,372,0,372
בית ג'ן,480,2,384,6,378
בית ג'ן,480,3,382,5,377
בית ג'ן,480,4,333,8,325
בית ג'ן,480,5,291,5,286
בית ג'ן,480,6,366,4,362
בית ג'ן,480,7,298,7,291
בית ג'ן,480,8,386,1,385
בית ג'ן,480,9,374,1,373
בית ג'ן,480,10,329,1,328
בית ג'ן,480,11,317,3,314
בית ג'ן,480,12,350,3,347
בית גוברין,619,1,220,0,220
בית גמליאל,571,1,255,1,254
בית גמליאל,571,2,308,1,307
בית דגן,466,1,571,1,570
בית דגן,466,2,355,1,354
בית דגן,466,3,382,0,382
בית דגן,466,4,468,4,464
בית דגן,466,5,478,4,474
בית דגן,466,6,429,2,427
בית דגן,466,7,636,3,633
בית דגן,466,8,455,2,453
בית הגדי,723,1,397,5,392
בית הלוי,373,1,420,1,419
בית הלל,322,1,391,0,391
בית העמק,572,1,339,2,337
בית הערבה,3645,1,53,2,51
בית השיטה,242,1,381,1,380
בית השיטה,242,2,369,5,364
בית זיד,353,1,68,0,68
בית זית,710,1,391,0,391
בית זית,710,2,414,3,411
בית זרע,143,1,402,0,402
בית חורון,3575,1,606,0,606
בית חירות,877,1,453,1,452
בית חלקיה,2033,1,330,2,328
בית חנן,159,1,476,0,476
בית חנניה,800,1,458,1,457
בית חשמונאי,1050,1,588,3,585
בית חשמונאי,1050,2,499,1,498
בית יהושע,288,1,530,1,529
בית יוסף,265,1,195,4,191
בית ינאי,200,1,222,0,222
בית יצחק-שער חפר,326,1,421,1,420
בית יצחק-שער חפר,326,2,423,2,421
בית יצחק-שער חפר,326,3,459,1,458
בית לחם הגלילית,430,1,443,4,439
בית מאיר,751,1,285,2,283
בית נחמיה,784,1,477,2,475
בית ניר,16,1,305,0,305
בית נקופה,672,1,315,1,314
בית עובד,202,1,225,0,225
בית עוזיאל,301,1,334,1,333
בית עזרא,756,1,292,4,288
בית עזרא,756,2,342,2,340
בית עריף,604,1,551,3,548
בית קמה,598,1,471,1,470
בית קשת,365,1,293,3,290
בית רבן,848,1,251,0,251
בית רימון,1162,1,241,0,241
בית שאן,9200,1,450,2,448
בית שאן,9200,2,426,12,414
בית שאן,9200,3,511,1,510
בית שאן,9200,4,379,2,377
בית שאן,9200,5,433,4,429
בית שאן,9200,6,476,2,474
בית שאן,9200,7,350,0,350
בית שאן,9200,8,373,1,372
בית שאן,9200,9,432,5,427
בית שאן,9200,10,420,6,414
בית שאן,9200,12,409,3,406
בית שאן,9200,13,269,3,266
בית שאן,9200,14,544,8,536
בית שאן,9200,15,568,3,565
בית שאן,9200,16,478,4,474
בית שאן,9200,17,426,1,425
בית שאן,9200,18,436,16,420
בית שאן,9200,19,458,5,453
בית שאן,9200,20,431,9,422
בית שאן,9200,21,464,7,457
בית שאן,9200,22,314,1,313
בית שאן,9200,23,361,2,359
בית שמש,2610,1,430,4,426
בית שמש,2610,2,467,6,461
בית שמש,2610,3,443,8,435
בית שמש,2610,4,458,7,451
בית שמש,2610,5,384,5,379
בית שמש,2610,6,416,3,413
בית שמש,2610,7,380,6,374
בית שמש,2610,8,524,1,523
בית שמש,2610,9,481,10,471
בית שמש,2610,10,460,9,451
בית שמש,2610,12,428,11,417
בית שמש,2610,13,366,17,349
בית שמש,2610,14,492,5,487
בית שמש,2610,15,471,1,470
בית שמש,2610,16,495,2,493
בית שמש,2610,17,504,1,503
בית שמש,2610,18,345,7,338
בית שמש,2610,19,437,15,422
בית שמש,2610,20,498,5,493
בית שמש,2610,21,371,7,364
בית שמש,2610,22,440,2,438
בית שמש,2610,23,385,6,379
בית שמש,2610,24,373,1,372
בית שמש,2610,25,416,8,408
בית שמש,2610,26,433,5,428
בית שמש,2610,27,366,2,364
בית שמש,2610,28,500,8,492
בית שמש,2610,29,348,9,339
בית שמש,2610,30,500,1,499
בית שמש,2610,31,415,17,398
בית שמש,2610,32,526,7,519
בית שמש,2610,33,510,9,501
בית שמש,2610,34,469,10,459
בית שמש,2610,35,371,1,370
בית שמש,2610,36,455,4,451
בית שמש,2610,37,562,11,551
בית שמש,2610,38,372,4,368
בית שמש,2610,39,357,12,345
בית שמש,2610,40,356,5,351
בית שמש,2610,41,389,4,385
בית שמש,2610,42,269,7,262
בית שמש,2610,43,218,5,213
בית שמש,2610,44,305,1,304
בית שמש,2610,45,268,8,260
בית שמש,2610,46,266,3,263
בית שמש,2610,50,513,13,500
בית שמש,2610,51,609,11,598
בית שמש,2610,52,558,7,551
בית שמש,2610,53,415,5,410
בית שמש,2610,54,557,5,552
בית שמש,2610,55,218,5,213
בית שמש,2610,56,341,10,331
בית שמש,2610,57,551,3,548
בית שמש,2610,58,390,2,388
בית שמש,2610,59,553,2,551
בית שמש,2610,60,138,0,138
בית שמש,2610,60,78,4,74
בית שמש,2610,61,365,5,360
בית שמש,2610,62,228,1,227
בית שמש,2610,63,339,10,329
בית שמש,2610,63,247,5,242
בית שמש,2610,64,539,11,528
בית שמש,2610,65,551,3,548
בית שמש,2610,66,494,3,491
בית שמש,2610,67,539,10,529
בית שמש,2610,68,207,9,198
בית שמש,2610,69,588,1,587
בית שמש,2610,70,411,3,408
בית שמש,2610,71,378,1,377
בית שמש,2610,72,493,12,481
בית שמש,2610,73,508,14,494
בית שמש,2610,74,358,6,352
בית שמש,2610,75,562,5,557
בית שמש,2610,76,448,1,447
בית שמש,2610,77,208,4,204
בית שמש,2610,78,514,3,511
בית שמש,2610,79,581,19,562
בית שמש,2610,80,530,4,526
בית שמש,2610,81,404,2,402
בית שמש,2610,82,389,8,381
בית שמש,2610,83,462,15,447
בית שמש,2610,84,399,2,397
בית שערים,248,1,408,0,408
בית שקמה,747,1,350,5,345
ביתן אהרן,252,1,93,1,92
ביתר עילית,3780,1,555,10,545
ביתר עילית,3780,2,459,0,459
ביתר עילית,3780,3,573,2,571
ביתר עילית,3780,4,448,0,448
ביתר עילית,3780,5,439,6,433
ביתר עילית,3780,6,464,2,462
ביתר עילית,3780,7,575,3,572
ביתר עילית,3780,8,499,5,494
ביתר עילית,3780,9,560,3,557
ביתר עילית,3780,10,365,0,365
ביתר עילית,3780,11,493,0,493
ביתר עילית,3780,12,473,9,464
ביתר עילית,3780,13,510,3,507
ביתר עילית,3780,15,657,1,656
ביתר עילית,3780,16,432,3,429
ביתר עילית,3780,17,681,4,677
ביתר עילית,3780,18,603,8,595
ביתר עילית,3780,19,366,2,364
ביתר עילית,3780,20,401,4,397
ביתר עילית,3780,20,313,1,312
ביתר עילית,3780,21,573,9,564
ביתר עילית,3780,22,538,7,531
ביתר עילית,3780,23,576,2,574
ביתר עילית,3780,24,509,7,502
ביתר עילית,3780,25,468,6,462
ביתר עילית,3780,26,510,13,497
ביתר עילית,3780,27,392,4,388
ביתר עילית,3780,28,404,4,400
ביתר עילית,3780,29,349,3,346
ביתר עילית,3780,31,635,15,620
ביתר עילית,3780,32,443,5,438
ביתר עילית,3780,33,389,3,386
ביתר עילית,3780,34,473,5,468
בלפוריה,94,1,272,1,271
בן זכאי,760,1,456,1,455
בן עמי,712,1,431,1,430
בן שמן (כפר נוער),1084,1,167,0,167
בן שמן (מושב),2013,1,460,1,459
בני ברק,6100,1,163,1,162
בני ברק,6100,2,587,6,581
בני ברק,6100,3,537,11,526
בני ברק,6100,4,589,14,575
בני ברק,6100,5,572,10,562
בני ברק,6100,6,561,4,557
בני ברק,6100,7,523,12,511
בני ברק,6100,8,259,2,257
בני ברק,6100,9,329,12,317
בני ברק,6100,10,439,7,432
בני ברק,6100,11,509,2,507
בני ברק,6100,12,498,5,493
בני ברק,6100,13,446,14,432
בני ברק,6100,14,529,8,521
בני ברק,6100,15,621,22,599
בני ברק,6100,16,389,10,379
בני ברק,6100,17,425,8,417
בני ברק,6100,18,400,8,392
בני ברק,6100,19,302,3,299
בני ברק,6100,20,303,2,301
בני ברק,6100,21,311,10,301
בני ברק,6100,22,390,14,376
בני ברק,6100,23,559,13,546
בני ברק,6100,24,427,11,416
בני ברק,6100,25,412,16,396
בני ברק,6100,26,400,4,396
בני ברק,6100,27,421,10,411
בני ברק,6100,28,375,10,365
בני ברק,6100,29,493,3,490
בני ברק,6100,30,441,8,433
בני ברק,6100,31,536,13,523
בני ברק,6100,32,463,6,457
בני ברק,6100,33,434,9,425
בני ברק,6100,34,515,7,508
בני ברק,6100,35,553,9,544
בני ברק,6100,36,482,14,468
בני ברק,6100,37,334,1,333
בני ברק,6100,38,404,11,393
בני ברק,6100,39,374,11,363
בני ברק,6100,40,526,21,505
בני ברק,6100,41,517,4,513
בני ברק,6100,42,509,17,492
בני ברק,6100,43,494,12,482
בני ברק,6100,44,350,7,343
בני ברק,6100,45,461,11,450
בני ברק,6100,46,551,16,535
בני ברק,6100,47,535,20,515
בני ברק,6100,48,448,23,425
בני ברק,6100,49,675,16,659
בני ברק,6100,50,591,34,557
בני ברק,6100,51,482,12,470
בני ברק,6100,52,358,2,356
בני ברק,6100,53,415,17,398
בני ברק,6100,54,633,17,616
בני ברק,6100,55,541,39,502
בני ברק,6100,56,615,13,602
בני ברק,6100,57,631,12,619
בני ברק,6100,58,547,19,528
בני ברק,6100,59,420,1,419
בני ברק,6100,60,543,18,525
בני ברק,6100,61,495,23,472
בני ברק,6100,62,572,17,555
בני ברק,6100,63,468,3,465
בני ברק,6100,64,474,11,463
בני ברק,6100,65,458,25,433
בני ברק,6100,66,597,4,593
בני ברק,6100,67,606,31,575
בני ברק,6100,68,507,26,481
בני ברק,6100,69,485,28,457
בני ברק,6100,70,628,22,606
בני ברק,6100,71,443,11,432
בני ברק,6100,72,578,12,566
בני ברק,6100,73,582,5,577
בני ברק,6100,74,571,9,562
בני ברק,6100,75,626,24,602
בני ברק,6100,76,511,29,482
בני ברק,6100,77,618,5,613
בני ברק,6100,78,548,21,527
בני ברק,6100,79,547,21,526
בני ברק,6100,80,568,25,543
בני ברק,6100,81,446,18,428
בני ברק,6100,82,480,32,448
בני ברק,6100,83,560,18,542
בני ברק,6100,84,453,19,434
בני ברק,6100,85,505,23,482
בני ברק,6100,86,611,12,599
בני ברק,6100,87,462,13,449
בני ברק,6100,88,416,3,413
בני ברק,6100,89,507,16,491
בני ברק,6100,90,531,17,514
בני ברק,6100,91,484,2,482
בני ברק,6100,92,550,42,508
בני ברק,6100,93,510,27,483
בני ברק,6100,94,321,16,305
בני ברק,6100,95,532,22,510
בני ברק,6100,96,316,31,285
בני ברק,6100,97,480,26,454
בני ברק,6100,98,519,23,496
בני ברק,6100,99,461,4,457
בני ברק,6100,100,486,17,469
בני ברק,6100,101,484,18,466
בני ברק,6100,102,560,29,531
בני ברק,6100,103,525,11,514
בני ברק,6100,104,598,3,595
בני ברק,6100,105,479,7,472
בני ברק,6100,106,589,9,580
בני ברק,6100,107,636,26,610
בני ברק,6100,108,482,6,476
בני ברק,6100,109,538,6,532
בני ברק,6100,110,559,34,525
בני ברק,6100,111,467,18,449
בני ברק,6100,112,461,47,414
בני ברק,6100,113,442,5,437
בני ברק,6100,114,512,8,504
בני ברק,6100,115,566,14,552
בני ברק,6100,116,467,8,459
בני ברק,6100,117,429,5,424
בני ברק,6100,118,499,8,491
בני ברק,6100,119,388,25,363
בני ברק,6100,120,248,14,234
בני ברק,6100,120,217,10,207
בני ברק,6100,121,496,28,468
בני ברק,6100,122,112,2,110
בני ברק,6100,123,504,2,502
בני ברק,6100,124,588,26,562
בני ברק,6100,125,488,13,475
בני ברק,6100,126,650,29,621
בני ברק,6100,127,567,6,561
בני ברק,6100,128,556,38,518
בני ברק,6100,129,520,13,507
בני ברק,6100,130,456,1,455
בני ברק,6100,131,564,11,553
בני ברק,6100,132,572,13,559
בני ברק,6100,133,482,9,473
בני ברק,6100,134,384,30,354
בני ברק,6100,135,617,27,590
בני ברק,6100,136,475,13,462
בני ברק,6100,137,473,18,455
בני ברק,6100,138,482,24,458
בני ברק,6100,139,512,13,499
בני ברק,6100,140,532,4,528
בני ברק,6100,141,355,8,347
בני ברק,6100,142,559,7,552
בני ברק,6100,143,251,23,228
בני ברק,6100,144,558,14,544
בני ברק,6100,145,577,12,565
בני ברק,6100,146,567,17,550
בני ברק,6100,147,425,14,411
בני ברק,6100,148,376,0,376
בני ברק,6100,149,414,7,407
בני ברק,6100,150,376,21,355
בני ברק,6100,151,461,24,437
בני ברק,6100,152,566,23,543
בני ברק,6100,153,465,17,448
בני ברק,6100,154,586,13,573
בני ברק,6100,155,524,15,509
בני ברק,6100,156,347,13,334
בני ברק,6100,157,565,20,545
בני ברק,6100,158,375,2,373
בני ברק,6100,159,555,9,546
בני ברק,6100,160,655,34,621
בני ברק,6100,161,393,17,376
בני ברק,6100,162,399,9,390
בני ברק,6100,165,542,15,527
בני ברק,6100,166,459,23,436
בני ברק,6100,167,469,17,452
בני ברק,6100,168,411,34,377
בני דקלים,1368,1,203,2,201
בני דרום,592,1,309,1,308
בני דרור,386,1,344,2,342
בני דרור,386,2,402,3,399
בני יהודה,4015,1,316,0,316
בני יהודה,4015,2,305,2,303
בני נצרים,1363,1,170,0,170
בני עטרות,448,1,497,0,497
"בני עי""ש",1066,1,564,6,558
"בני עי""ש",1066,2,410,1,409
"בני עי""ש",1066,3,383,7,376
"בני עי""ש",1066,4,403,17,386
"בני עי""ש",1066,5,385,5,380
"בני עי""ש",1066,6,388,9,379
"בני עי""ש",1066,7,320,13,307
"בני עי""ש",1066,8,392,2,390
"בני עי""ש",1066,9,395,11,384
"בני עי""ש",1066,10,407,4,403
בני ציון,418,1,343,1,342
בני ציון,418,2,320,0,320
בני ראם,588,1,336,2,334
בני ראם,588,2,318,1,317
בניה,685,1,529,3,526
בנימינה-גבעת עדה,9800,1,466,5,461
בנימינה-גבעת עדה,9800,2,471,1,470
בנימינה-גבעת עדה,9800,3,442,4,438
בנימינה-גבעת עדה,9800,4,380,2,378
בנימינה-גבעת עדה,9800,5,489,7,482
בנימינה-גבעת עדה,9800,6,585,1,584
בנימינה-גבעת עדה,9800,7,465,0,465
בנימינה-גבעת עדה,9800,8,480,5,475
בנימינה-גבעת עדה,9800,9,470,1,469
בנימינה-גבעת עדה,9800,10,409,7,402
בנימינה-גבעת עדה,9800,11,477,2,475
בנימינה-גבעת עדה,9800,101,504,1,503
בנימינה-גבעת עדה,9800,102,540,1,539
בנימינה-גבעת עדה,9800,103,432,0,432
בנימינה-גבעת עדה,9800,104,408,10,398
"בסמ""ה",1326,1,377,12,365
"בסמ""ה",1326,2,406,2,404
"בסמ""ה",1326,3,416,2,414
"בסמ""ה",1326,4,440,0,440
"בסמ""ה",1326,5,410,6,404
"בסמ""ה",1326,6,363,10,353
"בסמ""ה",1326,7,557,9,548
"בסמ""ה",1326,8,258,4,254
"בסמ""ה",1326,9,395,11,384
בסמת טבעון,944,1,398,9,389
בסמת טבעון,944,2,373,7,366
בסמת טבעון,944,3,282,5,277
בסמת טבעון,944,4,273,2,271
בסמת טבעון,944,5,355,2,353
בסמת טבעון,944,6,382,10,372
בסמת טבעון,944,7,330,4,326
בענה,483,1,522,1,521
בענה,483,2,482,1,481
בענה,483,3,585,2,583
בענה,483,4,484,1,483
בענה,483,5,601,1,600
בענה,483,6,532,5,527
בענה,483,7,618,0,618
בצרה,389,1,259,2,257
בצרה,389,2,297,1,296
בצת,589,1,212,2,210
בקוע,864,1,355,1,354
בקעות,3612,1,115,0,115
בר גיורא,823,1,300,5,295
בר יוחאי,1191,1,337,1,336
ברוכין,3744,1,198,0,198
ברור חיל,428,1,467,0,467
ברוש,2060,1,187,2,185
ברכה,3710,1,472,0,472
ברכה,3710,2,346,2,344
ברכיה,746,1,272,5,267
ברכיה,746,2,324,0,324
ברעם,667,1,340,0,340
ברק,141,1,225,1,224
ברקאי,617,1,330,3,327
ברקן,3654,1,405,0,405
ברקן,3654,2,493,2,491
ברקת,2038,1,474,0,474
ברקת,2038,2,379,0,379
בת הדר,1323,1,322,0,322
בת חן,1361,1,403,5,398
בת חפר,1319,1,485,0,485
בת חפר,1319,2,423,1,422
בת חפר,1319,3,522,2,520
בת חפר,1319,4,541,6,535
בת חפר,1319,5,447,0,447
בת חפר,1319,6,413,4,409
בת ים,6200,1,392,4,388
בת ים,6200,2,327,6,321
בת ים,6200,3,309,5,304
בת ים,6200,4,321,6,315
בת ים,6200,5,434,8,426
בת ים,6200,6,374,3,371
בת ים,6200,7,435,4,431
בת ים,6200,8,302,2,300
בת ים,6200,9,397,3,394
בת ים,6200,10,365,9,356
בת ים,6200,11,231,7,224
בת ים,6200,12,222,3,219
בת ים,6200,13,371,1,370
בת ים,6200,14,317,4,313
בת ים,6200,15,300,5,295
בת ים,6200,16,233,4,229
בת ים,6200,17,289,6,283
בת ים,6200,18,281,1,280
בת ים,6200,19,266,4,262
בת ים,6200,20,213,6,207
בת ים,6200,21,307,3,304
בת ים,6200,22,303,6,297
בת ים,6200,23,384,2,382
בת ים,6200,24,360,6,354
בת ים,6200,25,264,7,257
בת ים,6200,26,232,4,228
בת ים,6200,27,268,2,266
בת ים,6200,28,196,2,194
בת ים,6200,29,219,4,215
בת ים,6200,30,236,2,234
בת ים,6200,31,394,4,390
בת ים,6200,32,379,5,374
בת ים,6200,33,261,10,251
בת ים,6200,34,301,6,295
בת ים,6200,35,423,4,419
בת ים,6200,36,329,3,326
בת ים,6200,37,378,10,368
בת ים,6200,38,340,4,336
בת ים,6200,39,320,11,309
בת ים,6200,40,353,4,349
בת ים,6200,41,357,12,345
בת ים,6200,42,348,10,338
בת ים,6200,43,331,11,320
בת ים,6200,44,434,4,430
בת ים,6200,45,320,8,312
בת ים,6200,46,418,3,415
בת ים,6200,47,353,4,349
בת ים,6200,48,286,2,284
בת ים,6200,49,350,3,347
בת ים,6200,50,337,5,332
בת ים,6200,51,301,8,293
בת ים,6200,52,363,9,354
בת ים,6200,53,435,6,429
בת ים,6200,54,436,10,426
בת ים,6200,55,366,7,359
בת ים,6200,56,330,7,323
בת ים,6200,57,319,6,313
בת ים,6200,58,358,4,354
בת ים,6200,59,279,7,272
בת ים,6200,60,255,4,251
בת ים,6200,61,400,3,397
בת ים,6200,62,301,8,293
בת ים,6200,63,278,2,276
בת ים,6200,64,318,6,312
בת ים,6200,65,409,7,402
בת ים,6200,66,416,3,413
בת ים,6200,67,297,3,294
בת ים,6200,68,406,8,398
בת ים,6200,69,419,5,414
בת ים,6200,70,329,4,325
בת ים,6200,71,331,6,325
בת ים,6200,72,390,4,386
בת ים,6200,73,263,6,257
בת ים,6200,74,314,4,310
בת ים,6200,75,244,4,240
בת ים,6200,76,254,3,251
בת ים,6200,77,235,1,234
בת ים,6200,78,300,0,300
בת ים,6200,79,368,5,363
בת ים,6200,80,361,4,357
בת ים,6200,81,314,4,310
בת ים,6200,82,269,10,259
בת ים,6200,83,298,4,294
בת ים,6200,84,328,7,321
בת ים,6200,85,301,4,297
בת ים,6200,86,270,2,268
בת ים,6200,87,307,3,304
בת ים,6200,88,310,2,308
בת ים,6200,89,360,5,355
בת ים,6200,90,300,3,297
בת ים,6200,91,282,2,280
בת ים,6200,92,245,0,245
בת ים,6200,93,324,5,319
בת ים,6200,94,304,11,293
בת ים,6200,95,236,3,233
בת ים,6200,96,384,5,379
בת ים,6200,97,332,6,326
בת ים,6200,98,284,3,281
בת ים,6200,99,359,8,351
בת ים,6200,100,305,2,303
בת ים,6200,101,255,2,253
בת ים,6200,102,211,5,206
בת ים,6200,103,333,5,328
בת ים,6200,104,315,3,312
בת ים,6200,105,309,6,303
בת ים,6200,106,377,3,374
בת ים,6200,107,243,1,242
בת ים,6200,108,383,6,377
בת ים,6200,109,336,4,332
בת ים,6200,110,333,11,322
בת ים,6200,111,234,3,231
בת ים,6200,112,439,3,436
בת ים,6200,113,239,2,237
בת ים,6200,114,199,5,194
בת ים,6200,115,298,3,295
בת ים,6200,116,227,3,224
בת ים,6200,117,335,6,329
בת ים,6200,118,366,5,361
בת ים,6200,119,400,2,398
בת ים,6200,120,365,4,361
בת ים,6200,121,363,6,357
בת ים,6200,122,443,3,440
בת ים,6200,123,325,1,324
בת ים,6200,124,381,9,372
בת ים,6200,125,448,7,441
בת ים,6200,126,287,1,286
בת ים,6200,127,440,5,435
בת ים,6200,128,349,8,341
בת ים,6200,129,345,3,342
בת ים,6200,130,275,2,273
בת ים,6200,131,346,4,342
בת ים,6200,132,287,5,282
בת ים,6200,133,312,9,303
בת ים,6200,134,255,2,253
בת ים,6200,135,282,1,281
בת ים,6200,136,347,3,344
בת ים,6200,137,337,4,333
בת ים,6200,138,389,2,387
בת ים,6200,139,402,5,397
בת ים,6200,140,249,2,247
בת ים,6200,141,398,2,396
בת ים,6200,142,379,6,373
בת ים,6200,143,287,10,277
בת ים,6200,144,347,8,339
בת ים,6200,145,326,3,323
בת ים,6200,146,293,2,291
בת ים,6200,147,320,10,310
בת ים,6200,148,264,4,260
בת ים,6200,149,235,1,234
בת ים,6200,150,310,1,309
בת ים,6200,151,284,8,276
בת ים,6200,152,383,3,380
בת ים,6200,153,281,10,271
בת ים,6200,154,279,5,274
בת ים,6200,155,373,8,365
בת ים,6200,156,320,9,311
בת ים,6200,157,314,5,309
בת ים,6200,158,363,12,351
בת ים,6200,159,349,4,345
בת ים,6200,160,390,6,384
בת ים,6200,161,460,4,456
בת ים,6200,162,258,1,257
בת ים,6200,163,342,2,340
בת ים,6200,164,351,6,345
בת ים,6200,165,518,8,510
בת ים,6200,166,440,2,438
בת ים,6200,167,480,7,473
בת ים,6200,168,385,3,382
בת ים,6200,169,351,5,346
בת ים,6200,170,404,5,399
בת ים,6200,171,303,3,300
בת ים,6200,172,381,6,375
בת ים,6200,173,388,3,385
בת ים,6200,174,265,1,264
בת ים,6200,175,518,5,513
בת ים,6200,176,309,7,302
בת ים,6200,177,298,4,294
בת ים,6200,178,218,2,216
בת ים,6200,179,492,4,488
בת ים,6200,180,306,6,300
בת ים,6200,181,396,6,390
בת ים,6200,182,399,3,396
בת ים,6200,183,316,6,310
בת ים,6200,184,415,4,411
בת ים,6200,185,462,2,460
בת ים,6200,186,244,0,244
בת ים,6200,187,231,9,222
בת ים,6200,188,296,0,296
בת ים,6200,189,283,3,280
בת ים,6200,190,342,7,335
בת ים,6200,191,255,6,249
בת ים,6200,192,270,2,268
בת ים,6200,193,211,4,207
בת ים,6200,194,375,3,372
בת ים,6200,195,437,3,434
בת ים,6200,196,231,4,227
בת ים,6200,197,287,5,282
בת ים,6200,198,292,11,281
בת ים,6200,199,233,7,226
בת ים,6200,200,359,1,358
בת ים,6200,201,230,1,229
בת ים,6200,202,467,4,463
בת ים,6200,203,308,7,301
בת ים,6200,204,342,5,337
בת ים,6200,205,479,5,474
בת ים,6200,210,246,7,239
בת ים,6200,211,543,8,535
בת ים,6200,950,359,15,344
בת ים,6200,951,146,2,144
בת ים,6200,952,384,2,382
בת עין,3794,1,525,1,524
בת שלמה,33,1,323,3,320
ג'דיידה-מכר,1292,1,283,0,283
ג'דיידה-מכר,1292,2,438,0,438
ג'דיידה-מכר,1292,3,441,5,436
ג'דיידה-מכר,1292,4,498,4,494
ג'דיידה-מכר,1292,5,458,3,455
ג'דיידה-מכר,1292,6,475,2,473
ג'דיידה-מכר,1292,7,473,1,472
ג'דיידה-מכר,1292,8,529,1,528
ג'דיידה-מכר,1292,9,428,4,424
ג'דיידה-מכר,1292,10,501,0,501
ג'דיידה-מכר,1292,11,466,5,461
ג'דיידה-מכר,1292,12,467,4,463
ג'דיידה-מכר,1292,13,450,4,446
ג'דיידה-מכר,1292,14,444,3,441
ג'דיידה-מכר,1292,15,413,5,408
ג'דיידה-מכר,1292,16,485,4,481
ג'דיידה-מכר,1292,17,474,4,470
ג'דיידה-מכר,1292,18,494,1,493
ג'דיידה-מכר,1292,19,452,11,441
ג'ולס,485,1,359,3,356
ג'ולס,485,2,455,4,451
ג'ולס,485,3,434,11,423
ג'ולס,485,4,406,7,399
ג'ולס,485,5,438,5,433
ג'ולס,485,6,440,5,435
ג'לג'וליה,627,1,526,2,524
ג'לג'וליה,627,2,565,3,562
ג'לג'וליה,627,3,574,0,574
ג'לג'וליה,627,4,534,1,533
ג'לג'וליה,627,5,599,1,598
ג'לג'וליה,627,6,521,2,519
ג'לג'וליה,627,7,543,3,540
ג'לג'וליה,627,8,578,4,574
ג'נאביב (שבט),976,1,125,3,122
ג'סר א-זרקא,541,1,453,4,449
ג'סר א-זרקא,541,2,366,0,366
ג'סר א-זרקא,541,3,561,0,561
ג'סר א-זרקא,541,4,558,0,558
ג'סר א-זרקא,541,5,309,4,305
ג'סר א-זרקא,541,6,279,6,273
ג'סר א-זרקא,541,7,263,0,263
ג'סר א-זרקא,541,8,419,0,419
ג'סר א-זרקא,541,9,304,2,302
ג'סר א-זרקא,541,10,298,7,291
ג'סר א-זרקא,541,11,716,0,716
ג'ש (גוש חלב),487,1,316,4,312
ג'ש (גוש חלב),487,2,367,1,366
ג'ש (גוש חלב),487,3,379,5,374
ג'ש (גוש חלב),487,4,312,4,308
ג'ת,628,1,342,2,340
ג'ת,628,2,308,3,305
ג'ת,628,3,243,0,243
ג'ת,628,4,381,8,373
ג'ת,628,5,403,5,398
ג'ת,628,6,312,3,309
ג'ת,628,7,321,2,319
ג'ת,628,8,349,0,349
ג'ת,628,9,297,1,296
ג'ת,628,10,371,3,368
ג'ת,628,11,381,4,377
גאולי תימן,872,1,206,0,206
גאולים,379,1,528,6,522
גאליה,853,1,406,0,406
גאליה,853,2,234,0,234
גבולות,352,1,165,4,161
גבים,424,1,269,0,269
גבע בנימין,3763,1,601,6,595
גבע בנימין,3763,2,345,7,338
גבע בנימין,3763,2,308,4,304
גבע בנימין,3763,3,510,1,509
גבע בנימין,3763,4,418,3,415
גבע כרמל,683,1,265,4,261
גבע כרמל,683,2,255,0,255
גבע,86,1,389,2,387
גבעולים,2014,1,216,4,212
גבעון החדשה,3644,1,386,1,385
גבעון החדשה,3644,2,372,8,364
גבעות בר,1344,1,255,1,254
גבעת אבני,1293,1,333,1,332
גבעת אבני,1293,2,411,2,409
גבעת אבני,1293,3,459,3,456
גבעת אלה,1288,1,483,0,483
גבעת אלה,1288,2,348,0,348
גבעת אלה,1288,3,400,2,398
גבעת ברנר,147,1,475,3,472
גבעת ברנר,147,2,478,3,475
גבעת ברנר,147,3,411,0,411
גבעת השלושה,870,1,348,1,347
גבעת זאב,3730,1,535,2,533
גבעת זאב,3730,2,436,1,435
גבעת זאב,3730,3,430,1,429
גבעת זאב,3730,4,527,3,524
גבעת זאב,3730,5,499,2,497
גבעת זאב,3730,6,448,0,448
גבעת זאב,3730,7,391,2,389
גבעת זאב,3730,8,517,1,516
גבעת זאב,3730,9,498,4,494
גבעת זאב,3730,10,395,3,392
גבעת זאב,3730,11,475,3,472
גבעת זאב,3730,12,471,5,466
גבעת זאב,3730,13,407,7,400
גבעת זאב,3730,15,441,2,439
גבעת זאב,3730,16,367,8,359
גבעת זאב,3730,17,312,3,309
גבעת זאב,3730,18,306,0,306
גבעת זאב,3730,20,399,5,394
"גבעת ח""ן",207,1,252,3,249
גבעת חיים (איחוד),2018,1,321,0,321
גבעת חיים (איחוד),2018,2,370,0,370
גבעת חיים (מאוחד),173,1,338,5,333
גבעת חיים (מאוחד),173,2,349,0,349
גבעת יואב,4021,1,345,2,343
גבעת יערים,787,1,390,2,388
גבעת יערים,787,2,293,0,293
גבעת ישעיהו,919,1,376,2,374
"גבעת כ""ח",802,1,461,0,461
"גבעת ניל""י",360,1,333,0,333
גבעת עוז,703,1,269,2,267
גבעת שמואל,681,1,399,3,396
גבעת שמואל,681,2,530,2,528
גבעת שמואל,681,3,388,4,384
גבעת שמואל,681,4,506,4,502
גבעת שמואל,681,5,427,2,425
גבעת שמואל,681,6,383,4,379
גבעת שמואל,681,8,585,1,584
גבעת שמואל,681,9,427,1,426
גבעת שמואל,681,10,418,2,416
גבעת שמואל,681,11,428,1,427
גבעת שמואל,681,12,405,1,404
גבעת שמואל,681,13,611,0,611
גבעת שמואל,681,14,543,6,537
גבעת שמואל,681,15,659,1,658
גבעת שמואל,681,16,440,1,439
גבעת שמואל,681,17,421,2,419
גבעת שמואל,681,20,570,1,569
גבעת שמואל,681,21,598,3,595
גבעת שמואל,681,22,551,2,549
גבעת שמואל,681,23,672,3,669
גבעת שמואל,681,24,592,0,592
גבעת שמואל,681,25,492,0,492
גבעת שמואל,681,26,429,2,427
גבעת שמואל,681,27,398,3,395
גבעת שמואל,681,28,372,0,372
גבעת שמואל,681,950,568,2,566
גבעת שמואל,681,951,476,2,474
גבעת שפירא,1077,1,174,1,173
גבעתי,793,1,446,4,442
גבעתיים,6300,1,351,0,351
גבעתיים,6300,2,319,6,313
גבעתיים,6300,3,492,3,489
גבעתיים,6300,4,435,5,430
גבעתיים,6300,5,561,0,561
גבעתיים,6300,6,413,5,408
גבעתיים,6300,7,446,4,442
גבעתיים,6300,8,390,2,388
גבעתיים,6300,9,491,4,487
גבעתיים,6300,10,444,3,441
גבעתיים,6300,11,492,9,483
גבעתיים,6300,12,465,0,465
גבעתיים,6300,13,388,3,385
גבעתיים,6300,14,492,0,492
גבעתיים,6300,18,400,2,398
גבעתיים,6300,19,341,7,334
גבעתיים,6300,20,454,11,443
גבעתיים,6300,21,390,3,387
גבעתיים,6300,22,531,6,525
גבעתיים,6300,23,470,3,467
גבעתיים,6300,24,515,2,513
גבעתיים,6300,25,461,5,456
גבעתיים,6300,26,414,1,413
גבעתיים,6300,27,524,6,518
גבעתיים,6300,28,468,4,464
גבעתיים,6300,29,422,0,422
גבעתיים,6300,30,533,2,531
גבעתיים,6300,31,492,1,491
גבעתיים,6300,32,440,1,439
גבעתיים,6300,33,502,3,499
גבעתיים,6300,34,446,3,443
גבעתיים,6300,35,341,1,340
גבעתיים,6300,36,428,4,424
גבעתיים,6300,37,509,3,506
גבעתיים,6300,38,479,6,473
גבעתיים,6300,39,521,1,520
גבעתיים,6300,40,400,6,394
גבעתיים,6300,41,512,1,511
גבעתיים,6300,42,410,2,408
גבעתיים,6300,43,447,2,445
גבעתיים,6300,44,365,1,364
גבעתיים,6300,45,300,3,297
גבעתיים,6300,50,420,1,419
גבעתיים,6300,53,321,4,317
גבעתיים,6300,54,367,0,367
גבעתיים,6300,55,508,2,506
גבעתיים,6300,56,397,4,393
גבעתיים,6300,57,565,1,564
גבעתיים,6300,58,527,7,520
גבעתיים,6300,60,499,3,496
גבעתיים,6300,66,526,4,522
גבעתיים,6300,68,422,2,420
גבעתיים,6300,70,502,5,497
גבעתיים,6300,71,446,5,441
גבעתיים,6300,72,448,4,444
גבעתיים,6300,73,329,1,328
גבעתיים,6300,74,439,4,435
גבעתיים,6300,75,330,1,329
גבעתיים,6300,76,475,3,472
גבעתיים,6300,77,464,0,464
גבעתיים,6300,82,314,2,312
גבעתיים,6300,83,389,5,384
גבעתיים,6300,84,244,5,239
גבעתיים,6300,84,172,2,170
גבעתיים,6300,85,440,3,437
גבעתיים,6300,86,442,5,437
גבעתיים,6300,87,424,3,421
גבעתיים,6300,88,421,5,416
גבעתיים,6300,89,453,2,451
גבעתיים,6300,90,409,3,406
גבעתיים,6300,91,406,2,404
גבעתיים,6300,92,456,5,451
גבעתיים,6300,93,341,3,338
גבעתיים,6300,94,621,2,619
גבעתיים,6300,95,336,0,336
גבעתיים,6300,96,406,2,404
גבעתיים,6300,97,453,5,448
גבעתיים,6300,98,321,2,319
גברעם,342,1,211,0,211
גבת,133,1,278,4,274
גבת,133,2,262,1,261
גדות,35,1,243,0,243
גדיש,145,1,197,5,192
גדעונה,442,1,190,3,187
גדרה,2550,1,422,3,419
גדרה,2550,2,602,6,596
גדרה,2550,3,522,6,516
גדרה,2550,4,567,6,561
גדרה,2550,5,440,2,438
גדרה,2550,6,570,4,566
גדרה,2550,7,382,8,374
גדרה,2550,8,534,1,533
גדרה,2550,9,556,5,551
גדרה,2550,10,348,4,344
גדרה,2550,11,468,1,467
גדרה,2550,12,610,4,606
גדרה,2550,13,629,2,627
גדרה,2550,14,421,5,416
גדרה,2550,15,514,3,511
גדרה,2550,16,396,3,393
גדרה,2550,17,470,4,466
גדרה,2550,18,342,8,334
גדרה,2550,19,582,5,577
גדרה,2550,20,518,16,502
גדרה,2550,21,321,1,320
גדרה,2550,22,351,4,347
גדרה,2550,23,428,0,428
גדרה,2550,24,442,1,441
גדרה,2550,25,444,3,441
גונן,852,1,244,0,244
גורן,755,1,264,4,260
גורנות הגליל,1219,1,107,0,107
גזית,457,1,436,0,436
גזר,370,1,191,0,191
גיאה,706,1,422,3,419
גיבתון,196,1,193,0,193
גיזו,1043,1,102,0,102
גילון,1204,1,338,1,337
גילון,1204,2,334,0,334
גילת,736,1,274,0,274
גילת,736,2,397,1,396
גינוסר,262,1,372,6,366
גיניגר,92,1,382,1,381
גינתון,863,1,499,1,498
גיתה,1206,1,134,1,133
גיתית,3613,1,150,0,150
גלאון,393,1,264,2,262
גלגל,3606,1,82,0,82
גליל ים,346,1,271,2,269
גלעד (אבן יצחק),369,1,272,1,271
גמזו,745,1,531,1,530
גן הדרום,1072,1,264,0,264
גן השומרון,225,1,452,0,452
גן חיים,239,1,442,3,439
גן יאשיה,734,1,481,1,480
גן יבנה,166,1,515,3,512
גן יבנה,166,2,539,4,535
גן יבנה,166,3,523,1,522
גן יבנה,166,4,417,1,416
גן יבנה,166,5,363,2,361
גן יבנה,166,6,582,11,571
גן יבנה,166,7,440,0,440
גן יבנה,166,8,438,4,434
גן יבנה,166,9,413,5,408
גן יבנה,166,10,555,1,554
גן יבנה,166,11,476,0,476
גן יבנה,166,12,447,1,446
גן יבנה,166,13,412,3,409
גן יבנה,166,14,497,0,497
גן יבנה,166,15,365,4,361
גן יבנה,166,16,378,1,377
גן יבנה,166,17,410,0,410
גן יבנה,166,18,445,6,439
גן יבנה,166,19,517,5,512
גן יבנה,166,20,482,2,480
גן יבנה,166,21,615,9,606
גן יבנה,166,22,358,1,357
גן יבנה,166,23,461,5,456
גן יבנה,166,24,451,2,449
גן נר,1274,1,486,5,481
גן נר,1274,2,527,2,525
גן נר,1274,3,396,0,396
גן שורק,311,1,199,1,198
גן שלמה,144,1,304,3,301
גן שמואל,72,1,313,3,310
גן שמואל,72,2,362,1,361
גנות הדר,549,1,494,1,493
גנות,836,1,286,2,284
גני הדר,1103,1,187,1,186
גני טל,1371,1,295,0,295
גני יוחנן,862,1,401,6,395
גני עם,218,1,160,0,160
גני תקווה,229,1,573,3,570
גני תקווה,229,2,531,2,529
גני תקווה,229,3,283,2,281
גני תקווה,229,4,629,3,626
גני תקווה,229,5,539,4,535
גני תקווה,229,6,410,3,407
גני תקווה,229,7,337,3,334
גני תקווה,229,8,518,5,513
גני תקווה,229,9,518,2,516
גני תקווה,229,10,495,2,493
גני תקווה,229,11,312,7,305
גני תקווה,229,12,528,0,528
גני תקווה,229,13,345,0,345
גני תקווה,229,14,530,3,527
גני תקווה,229,15,566,4,562
גני תקווה,229,16,397,5,392
גני תקווה,229,20,516,5,511
גני תקווה,229,21,554,0,554
גני תקווה,229,22,594,6,588
געש,842,1,456,4,452
געתון,463,1,312,2,310
גפן,39,1,197,3,194
גרופית,1129,1,187,2,185
גשור,4022,1,138,1,137
גשר הזיו,574,1,471,4,467
גשר הזיו,574,2,354,2,352
גשר,305,1,281,0,281
גת (קיבוץ),340,1,332,1,331
גת רימון,128,1,152,0,152
דאלית אל-כרמל,494,1,266,5,261
דאלית אל-כרמל,494,2,454,4,450
דאלית אל-כרמל,494,3,471,8,463
דאלית אל-כרמל,494,4,430,5,425
דאלית אל-כרמל,494,5,420,15,405
דאלית אל-כרמל,494,6,388,6,382
דאלית אל-כרמל,494,7,460,15,445
דאלית אל-כרמל,494,8,410,6,404
דאלית אל-כרמל,494,9,335,7,328
דאלית אל-כרמל,494,10,421,15,406
דאלית אל-כרמל,494,11,374,6,368
דאלית אל-כרמל,494,12,419,6,413
דאלית אל-כרמל,494,13,414,8,406
דאלית אל-כרמל,494,14,395,8,387
דאלית אל-כרמל,494,15,405,3,402
דאלית אל-כרמל,494,16,342,4,338
דאלית אל-כרמל,494,17,386,3,383
דבורה,146,1,163,2,161
דבוריה,489,1,420,0,420
דבוריה,489,2,517,2,515
דבוריה,489,3,526,2,524
דבוריה,489,4,544,0,544
דבוריה,489,5,521,0,521
דבוריה,489,6,476,1,475
דבוריה,489,7,505,2,503
דבוריה,489,8,498,1,497
דבוריה,489,9,505,0,505
דבירה,849,1,398,0,398
דברת,407,1,163,2,161
דגניה א',62,1,368,2,366
דגניה ב',79,1,407,3,404
"דוב""ב",1067,1,217,0,217
דולב,3747,1,611,3,608
דור,738,1,220,1,219
דורות,336,1,384,2,382
דחי,475,1,259,3,256
דייר אל-אסד,490,1,576,2,574
דייר אל-אסד,490,2,614,4,610
דייר אל-אסד,490,3,653,0,653
דייר אל-אסד,490,4,529,5,524
דייר אל-אסד,490,5,454,25,429
דייר אל-אסד,490,6,564,1,563
דייר אל-אסד,490,7,597,0,597
דייר אל-אסד,490,8,588,4,584
דייר אל-אסד,490,9,576,3,573
דייר אל-אסד,490,10,564,3,561
דייר חנא,492,1,606,0,606
דייר חנא,492,2,484,2,482
דייר חנא,492,3,457,0,457
דייר חנא,492,4,618,6,612
דייר חנא,492,5,675,3,672
דייר חנא,492,6,491,1,490
דייר חנא,492,7,515,9,506
דייר חנא,492,8,516,1,515
דייר חנא,492,9,559,1,558
דייר חנא,492,10,418,0,418
דימונה,2200,1,376,3,373
דימונה,2200,2,316,4,312
דימונה,2200,3,289,4,285
דימונה,2200,4,338,13,325
דימונה,2200,5,342,6,336
דימונה,2200,6,328,0,328
דימונה,2200,8,243,8,235
דימונה,2200,9,366,14,352
דימונה,2200,10,395,6,389
דימונה,2200,11,290,6,284
דימונה,2200,12,304,9,295
דימונה,2200,13,306,3,303
דימונה,2200,14,256,4,252
דימונה,2200,15,271,7,264
דימונה,2200,17,256,9,247
דימונה,2200,18,247,3,244
דימונה,2200,19,403,8,395
דימונה,2200,20,221,3,218
דימונה,2200,21,268,6,262
דימונה,2200,22,301,4,297
דימונה,2200,23,248,7,241
דימונה,2200,24,250,8,242
דימונה,2200,25,360,4,356
דימונה,2200,27,487,8,479
דימונה,2200,28,341,6,335
דימונה,2200,29,388,3,385
דימונה,2200,30,399,10,389
דימונה,2200,31,409,8,401
דימונה,2200,32,357,6,351
דימונה,2200,33,428,7,421
דימונה,2200,34,210,7,203
דימונה,2200,36,439,13,426
דימונה,2200,37,375,9,366
דימונה,2200,39,419,3,416
דימונה,2200,40,516,2,514
דימונה,2200,41,493,8,485
דימונה,2200,42,570,9,561
דימונה,2200,43,440,4,436
דימונה,2200,44,352,7,345
דימונה,2200,45,362,7,355
דימונה,2200,46,418,4,414
דימונה,2200,47,536,1,535
דימונה,2200,66,387,11,376
דימונה,2200,67,337,7,330
דימונה,2200,68,382,1,381
דימונה,2200,69,326,4,322
דימונה,2200,90,50,0,50
דישון,2063,1,204,1,203
דליה,300,1,245,0,245
דליה,300,2,277,0,277
דלתון,431,1,431,4,427
דמיידה,1317,1,188,3,185
דן,303,1,357,1,356
דפנה,302,1,444,2,442
דקל,1241,1,164,0,164
דריג'את,1349,1,287,2,285
האון,702,1,102,1,101
הבונים,675,1,208,0,208
הגושרים,356,1,414,0,414
הדר עם,191,1,376,0,376
הוד השרון,9700,1,600,4,596
הוד השרון,9700,2,521,3,518
הוד השרון,9700,3,586,0,586
הוד השרון,9700,4,486,4,482
הוד השרון,9700,5,527,1,526
הוד השרון,9700,6,380,3,377
הוד השרון,9700,7,334,4,330
הוד השרון,9700,8,483,4,479
הוד השרון,9700,9,483,1,482
הוד השרון,9700,10,413,1,412
הוד השרון,9700,11,561,1,560
הוד השרון,9700,12,584,1,583
הוד השרון,9700,13,472,0,472
הוד השרון,9700,14,517,0,517
הוד השרון,9700,15,461,1,460
הוד השרון,9700,16,550,1,549
הוד השרון,9700,17,383,0,383
הוד השרון,9700,18,463,1,462
הוד השרון,9700,19,376,0,376
הוד השרון,9700,20,434,4,430
הוד השרון,9700,21,486,4,482
הוד השרון,9700,22,438,1,437
הוד השרון,9700,23,373,5,368
הוד השרון,9700,24,634,0,634
הוד השרון,9700,25,611,3,608
הוד השרון,9700,26,500,3,497
הוד השרון,9700,27,500,1,499
הוד השרון,9700,28,436,2,434
הוד השרון,9700,29,596,4,592
הוד השרון,9700,30,472,2,470
הוד השרון,9700,31,393,6,387
הוד השרון,9700,32,497,1,496
הוד השרון,9700,33,582,2,580
הוד השרון,9700,34,525,2,523
הוד השרון,9700,35,536,5,531
הוד השרון,9700,36,552,0,552
הוד השרון,9700,37,393,0,393
הוד השרון,9700,38,525,2,523
הוד השרון,9700,39,519,3,516
הוד השרון,9700,40,378,1,377
הוד השרון,9700,40,344,0,344
הוד השרון,9700,41,590,1,589
הוד השרון,9700,42,438,3,435
הוד השרון,9700,43,635,4,631
הוד השרון,9700,44,488,1,487
הוד השרון,9700,45,576,2,574
הוד השרון,9700,46,318,2,316
הוד השרון,9700,47,530,2,528
הוד השרון,9700,48,433,0,433
הוד השרון,9700,49,306,4,302
הוד השרון,9700,50,506,8,498
הוד השרון,9700,51,455,3,452
הוד השרון,9700,52,425,3,422
הוד השרון,9700,53,589,2,587
הוד השרון,9700,54,458,11,447
הוד השרון,9700,55,576,3,573
הוד השרון,9700,56,367,4,363
הוד השרון,9700,57,461,3,458
הוד השרון,9700,58,552,3,549
הוד השרון,9700,59,425,1,424
הוד השרון,9700,60,408,1,407
הוד השרון,9700,61,427,1,426
הוד השרון,9700,62,502,0,502
הוד השרון,9700,63,379,1,378
הודיה,726,1,325,2,323
הוואשלה (שבט),1169,1,306,1,305
הוואשלה (שבט),1169,2,215,5,210
הוזייל (שבט),956,1,188,2,186
הוזייל (שבט),956,2,122,0,122
הושעיה,1186,1,460,0,460
הושעיה,1186,2,474,0,474
הזורע,250,1,315,2,313
הזורע,250,2,273,0,273
הזורעים,307,1,390,0,390
החותרים,434,1,399,1,398
היוגב,684,1,434,2,432
הילה,1208,1,343,1,342
המעפיל,377,1,440,2,438
הסוללים,677,1,504,1,503
העוגן,423,1,248,5,243
העוגן,423,2,214,1,213
הר אדר,3769,1,347,3,344
הר אדר,3769,2,396,0,396
הר אדר,3769,3,436,7,429
הר אדר,3769,4,575,0,575
הר אדר,3769,5,381,0,381
הר גילה,3603,1,385,1,384
הר גילה,3603,2,309,2,307
הר עמשא,1261,1,124,1,123
הראל,464,1,104,0,104
הרדוף,1249,1,292,2,290
הרצליה,6400,1,311,4,307
הרצליה,6400,2,341,5,336
הרצליה,6400,3,429,8,421
הרצליה,6400,4,508,5,503
הרצליה,6400,5,494,5,489
הרצליה,6400,6,503,5,498
הרצליה,6400,7,374,5,369
הרצליה,6400,8,329,3,326
הרצליה,6400,9,374,8,366
הרצליה,6400,10,424,5,419
הרצליה,6400,11,547,4,543
הרצליה,6400,17,430,2,428
הרצליה,6400,18,299,0,299
הרצליה,6400,19,369,2,367
הרצליה,6400,20,519,1,518
הרצליה,6400,21,484,5,479
הרצליה,6400,22,358,4,354
הרצליה,6400,23,477,0,477
הרצליה,6400,24,290,2,288
הרצליה,6400,25,348,1,347
הרצליה,6400,26,411,7,404
הרצליה,6400,27,379,3,376
הרצליה,6400,28,481,1,480
הרצליה,6400,29,579,4,575
הרצליה,6400,30,351,1,350
הרצליה,6400,31,545,1,544
הרצליה,6400,32,460,6,454
הרצליה,6400,33,494,7,487
הרצליה,6400,34,521,3,518
הרצליה,6400,35,377,9,368
הרצליה,6400,36,438,5,433
הרצליה,6400,37,354,1,353
הרצליה,6400,38,406,4,402
הרצליה,6400,39,449,2,447
הרצליה,6400,40,402,6,396
הרצליה,6400,41,419,3,416
הרצליה,6400,42,480,5,475
הרצליה,6400,43,447,6,441
הרצליה,6400,44,352,0,352
הרצליה,6400,45,501,3,498
הרצליה,6400,46,323,4,319
הרצליה,6400,47,360,3,357
הרצליה,6400,48,389,9,380
הרצליה,6400,49,436,1,435
הרצליה,6400,50,344,6,338
הרצליה,6400,51,342,3,339
הרצליה,6400,52,541,1,540
הרצליה,6400,53,413,4,409
הרצליה,6400,54,388,4,384
הרצליה,6400,55,336,3,333
הרצליה,6400,56,542,6,536
הרצליה,6400,57,273,1,272
הרצליה,6400,58,450,2,448
הרצליה,6400,59,400,2,398
הרצליה,6400,60,379,3,376
הרצליה,6400,61,337,0,337
הרצליה,6400,62,438,2,436
הרצליה,6400,63,546,1,545
הרצליה,6400,64,458,1,457
הרצליה,6400,65,432,2,430
הרצליה,6400,66,369,3,366
הרצליה,6400,67,359,2,357
הרצליה,6400,68,577,5,572
הרצליה,6400,69,452,2,450
הרצליה,6400,70,508,7,501
הרצליה,6400,71,439,7,432
הרצליה,6400,72,379,3,376
הרצליה,6400,73,325,3,322
הרצליה,6400,74,365,2,363
הרצליה,6400,75,433,3,430
הרצליה,6400,76,356,2,354
הרצליה,6400,77,436,1,435
הרצליה,6400,78,430,2,428
הרצליה,6400,79,493,4,489
הרצליה,6400,80,275,4,271
הרצליה,6400,81,445,1,444
הרצליה,6400,82,492,1,491
הרצליה,6400,83,438,1,437
הרצליה,6400,84,463,3,460
הרצליה,6400,85,422,3,419
הרצליה,6400,86,330,3,327
הרצליה,6400,87,418,1,417
הרצליה,6400,88,480,1,479
הרצליה,6400,89,455,2,453
הרצליה,6400,90,372,4,368
הרצליה,6400,91,568,2,566
הרצליה,6400,92,320,7,313
הרצליה,6400,93,344,2,342
הרצליה,6400,94,383,2,381
הרצליה,6400,95,473,2,471
הרצליה,6400,96,411,3,408
הרצליה,6400,97,461,0,461
הרצליה,6400,98,398,1,397
הרצליה,6400,99,475,2,473
הרצליה,6400,100,406,9,397
הרצליה,6400,101,443,4,439
הרצליה,6400,102,403,3,400
הרצליה,6400,103,369,4,365
הרצליה,6400,104,481,4,477
הרצליה,6400,105,330,6,324
הרצליה,6400,106,486,0,486
הרצליה,6400,107,475,7,468
הרצליה,6400,108,322,1,321
הרצליה,6400,109,586,5,581
הרצליה,6400,110,316,1,315
הרצליה,6400,111,393,3,390
הרצליה,6400,112,492,2,490
הרצליה,6400,113,363,2,361
הרצליה,6400,114,598,0,598
הרצליה,6400,115,418,2,416
הרצליה,6400,116,470,5,465
הרצליה,6400,118,383,2,381
הרצליה,6400,119,402,2,400
הרצליה,6400,120,533,0,533
הרצליה,6400,121,416,1,415
הרצליה,6400,122,437,5,432
הרצליה,6400,123,380,0,380
הרצליה,6400,124,483,8,475
הרצליה,6400,125,288,2,286
הרצליה,6400,126,387,5,382
הרצליה,6400,127,327,4,323
הרצליה,6400,128,328,0,328
הרצליה,6400,129,425,1,424
הרצליה,6400,130,398,0,398
הרצליה,6400,131,547,5,542
הרצליה,6400,135,381,1,380
הרצליה,6400,140,285,2,283
הרצליה,6400,141,580,1,579
הרצליה,6400,951,223,1,222
הררית,1203,1,199,2,197
ורד יריחו,3639,1,136,1,135
ורדון,1133,1,150,2,148
זבדיאל,815,1,310,2,308
זוהר,44,1,200,1,199
זיקים,584,1,386,0,386
זיתן,788,1,273,4,269
זיתן,788,2,388,3,385
זכרון יעקב,9300,1,463,2,461
זכרון יעקב,9300,2,509,0,509
זכרון יעקב,9300,3,383,2,381
זכרון יעקב,9300,4,528,0,528
זכרון יעקב,9300,5,397,2,395
זכרון יעקב,9300,6,519,3,516
זכרון יעקב,9300,7,574,3,571
זכרון יעקב,9300,8,516,1,515
זכרון יעקב,9300,9,507,2,505
זכרון יעקב,9300,10,517,2,515
זכרון יעקב,9300,11,521,3,518
זכרון יעקב,9300,12,621,0,621
זכרון יעקב,9300,13,423,6,417
זכרון יעקב,9300,14,543,3,540
זכרון יעקב,9300,15,485,1,484
זכרון יעקב,9300,16,388,1,387
זכרון יעקב,9300,17,601,2,599
זכרון יעקב,9300,18,540,2,538
זכרון יעקב,9300,19,486,2,484
זכרון יעקב,9300,20,495,1,494
זכרון יעקב,9300,21,416,0,416
זכרון יעקב,9300,22,468,2,466
זכרון יעקב,9300,23,326,2,324
זכרון יעקב,9300,24,485,2,483
זכריה,799,1,554,0,554
זמר,1290,1,432,5,427
זמר,1290,2,379,3,376
זמר,1290,3,277,0,277
זמר,1290,4,368,2,366
זמר,1290,5,497,0,497
זמר,1290,6,324,0,324
זמר,1290,7,306,5,301
זמרת,1065,1,229,1,228
זנוח,816,1,277,4,273
זרועה,2064,1,173,2,171
זרזיר,975,1,245,1,244
זרזיר,975,2,321,2,319
זרזיר,975,3,317,5,312
זרזיר,975,4,366,2,364
זרזיר,975,5,352,1,351
זרזיר,975,6,327,7,320
זרזיר,975,7,326,2,324
זרחיה,818,1,355,0,355
ח'ואלד (שבט),986,1,71,2,69
ח'ואלד,1321,1,147,3,144
חבצלת השרון,235,1,225,6,219
חבר,1110,1,169,2,167
חברון,3400,1,231,0,231
חגור,717,1,560,0,560
חגי,3764,1,225,0,225
חגלה,205,1,380,2,378
חד-נס,4026,1,420,1,419
חדיד,618,1,470,3,467
חדרה,6500,1,283,2,281
חדרה,6500,2,426,7,419
חדרה,6500,3,479,4,475
חדרה,6500,4,362,6,356
חדרה,6500,5,503,5,498
חדרה,6500,6,492,1,491
חדרה,6500,7,442,8,434
חדרה,6500,8,353,6,347
חדרה,6500,9,282,2,280
חדרה,6500,10,535,5,530
חדרה,6500,11,507,2,505
חדרה,6500,12,470,3,467
חדרה,6500,13,494,0,494
חדרה,6500,14,326,1,325
חדרה,6500,15,367,3,364
חדרה,6500,16,487,2,485
חדרה,6500,17,577,3,574
חדרה,6500,18,420,5,415
חדרה,6500,19,271,1,270
חדרה,6500,20,247,9,238
חדרה,6500,21,423,13,410
חדרה,6500,22,211,0,211
חדרה,6500,23,391,6,385
חדרה,6500,24,459,1,458
חדרה,6500,25,548,5,543
חדרה,6500,26,454,4,450
חדרה,6500,27,308,3,305
חדרה,6500,28,319,3,316
חדרה,6500,29,400,6,394
חדרה,6500,30,500,5,495
חדרה,6500,31,287,8,279
חדרה,6500,32,579,4,575
חדרה,6500,33,298,4,294
חדרה,6500,34,465,4,461
חדרה,6500,35,452,10,442
חדרה,6500,36,259,1,258
חדרה,6500,37,366,6,360
חדרה,6500,38,431,6,425
חדרה,6500,39,327,4,323
חדרה,6500,40,515,8,507
חדרה,6500,41,374,3,371
חדרה,6500,42,384,2,382
חדרה,6500,43,355,4,351
חדרה,6500,44,366,4,362
חדרה,6500,45,451,13,438
חדרה,6500,46,419,11,408
חדרה,6500,47,388,11,377
חדרה,6500,48,353,3,350
חדרה,6500,49,435,7,428
חדרה,6500,50,440,7,433
חדרה,6500,51,341,31,310
חדרה,6500,52,370,7,363
חדרה,6500,53,334,5,329
חדרה,6500,54,545,3,542
חדרה,6500,55,414,9,405
חדרה,6500,56,434,6,428
חדרה,6500,57,383,3,380
חדרה,6500,58,355,5,350
חדרה,6500,59,513,3,510
חדרה,6500,60,490,4,486
חדרה,6500,61,293,0,293
חדרה,6500,62,462,6,456
חדרה,6500,63,468,3,465
חדרה,6500,64,514,2,512
חדרה,6500,65,497,2,495
חדרה,6500,66,424,2,422
חדרה,6500,67,317,7,310
חדרה,6500,68,341,5,336
חדרה,6500,69,521,5,516
חדרה,6500,70,405,7,398
חדרה,6500,71,393,7,386
חדרה,6500,72,472,5,467
חדרה,6500,73,312,7,305
חדרה,6500,74,344,6,338
חדרה,6500,75,403,10,393
חדרה,6500,76,425,4,421
חדרה,6500,77,374,6,368
חדרה,6500,78,299,8,291
חדרה,6500,79,517,2,515
חדרה,6500,80,328,0,328
חדרה,6500,81,364,3,361
חדרה,6500,82,372,2,370
חדרה,6500,84,422,4,418
חדרה,6500,85,340,2,338
חדרה,6500,86,569,4,565
חדרה,6500,88,258,5,253
חדרה,6500,89,392,12,380
חדרה,6500,90,424,6,418
חדרה,6500,91,442,3,439
חדרה,6500,92,354,3,351
חדרה,6500,93,278,3,275
חדרה,6500,94,248,5,243
חדרה,6500,95,320,6,314
חדרה,6500,96,310,4,306
חדרה,6500,97,335,5,330
חדרה,6500,98,333,10,323
חדרה,6500,99,410,2,408
חדרה,6500,100,492,7,485
חדרה,6500,101,581,4,577
חדרה,6500,102,434,3,431
חדרה,6500,103,583,3,580
חדרה,6500,104,470,9,461
חדרה,6500,105,505,4,501
חדרה,6500,106,365,2,363
חדרה,6500,107,338,5,333
חדרה,6500,109,392,7,385
חדרה,6500,110,541,7,534
חדרה,6500,111,543,3,540
חדרה,6500,112,422,3,419
חדרה,6500,113,336,3,333
חדרה,6500,951,538,3,535
חולדה,160,1,432,1,431
חולון,6600,1,463,11,452
חולון,6600,2,485,8,477
חולון,6600,3,441,1,440
חולון,6600,4,346,2,344
חולון,6600,5,439,3,436
חולון,6600,6,406,1,405
חולון,6600,7,451,5,446
חולון,6600,8,508,1,507
חולון,6600,9,416,2,414
חולון,6600,10,372,4,368
חולון,6600,11,347,0,347
חולון,6600,12,495,6,489
חולון,6600,13,421,5,416
חולון,6600,14,418,1,417
חולון,6600,16,456,3,453
חולון,6600,17,459,3,456
חולון,6600,18,429,2,427
חולון,6600,19,337,3,334
חולון,6600,20,416,2,414
חולון,6600,21,332,0,332
חולון,6600,22,383,3,380
חולון,6600,23,369,2,367
חולון,6600,24,427,5,422
חולון,6600,25,480,4,476
חולון,6600,26,487,4,483
חולון,6600,27,467,0,467
חולון,6600,28,252,2,250
חולון,6600,29,369,8,361
חולון,6600,30,394,3,391
חולון,6600,31,250,2,248
חולון,6600,32,274,6,268
חולון,6600,33,412,2,410
חולון,6600,34,396,1,395
חולון,6600,35,469,4,465
חולון,6600,36,286,4,282
חולון,6600,37,373,5,368
חולון,6600,38,401,6,395
חולון,6600,39,467,6,461
חולון,6600,40,364,4,360
חולון,6600,41,286,3,283
חולון,6600,42,455,3,452
חולון,6600,43,308,7,301
חולון,6600,44,327,2,325
חולון,6600,45,338,6,332
חולון,6600,46,359,4,355
חולון,6600,47,420,4,416
חולון,6600,48,486,9,477
חולון,6600,49,338,5,333
חולון,6600,50,308,5,303
חולון,6600,51,284,1,283
חולון,6600,52,480,3,477
חולון,6600,53,429,6,423
חולון,6600,54,275,2,273
חולון,6600,55,284,5,279
חולון,6600,56,400,5,395
חולון,6600,57,276,6,270
חולון,6600,58,286,2,284
חולון,6600,59,366,3,363
חולון,6600,60,410,2,408
חולון,6600,61,486,8,478
חולון,6600,62,323,6,317
חולון,6600,63,377,4,373
חולון,6600,64,343,1,342
חולון,6600,65,345,5,340
חולון,6600,66,426,3,423
חולון,6600,67,410,1,409
חולון,6600,68,304,4,300
חולון,6600,69,277,2,275
חולון,6600,70,163,2,161
חולון,6600,70,155,5,150
חולון,6600,71,313,8,305
חולון,6600,72,356,5,351
חולון,6600,73,366,4,362
חולון,6600,75,441,7,434
חולון,6600,76,366,8,358
חולון,6600,77,344,7,337
חולון,6600,78,456,2,454
חולון,6600,79,418,1,417
חולון,6600,80,422,6,416
חולון,6600,81,448,2,446
חולון,6600,82,290,5,285
חולון,6600,83,338,6,332
חולון,6600,84,488,5,483
חולון,6600,85,395,10,385
חולון,6600,86,400,1,399
חולון,6600,87,407,8,399
חולון,6600,88,412,6,406
חולון,6600,89,283,5,278
חולון,6600,90,374,4,370
חולון,6600,91,366,11,355
חולון,6600,92,389,4,385
חולון,6600,93,359,7,352
חולון,6600,94,420,10,410
חולון,6600,95,334,2,332
חולון,6600,96,477,3,474
חולון,6600,97,351,1,350
חולון,6600,98,316,6,310
חולון,6600,99,366,6,360
חולון,6600,100,418,2,416
חולון,6600,101,476,4,472
חולון,6600,102,379,6,373
חולון,6600,103,390,8,382
חולון,6600,104,350,3,347
חולון,6600,105,264,4,260
חולון,6600,106,405,5,400
חולון,6600,107,437,2,435
חולון,6600,108,316,7,309
חולון,6600,109,429,5,424
חולון,6600,110,430,6,424
חולון,6600,111,398,9,389
חולון,6600,112,349,5,344
חולון,6600,113,360,1,359
חולון,6600,114,353,4,349
חולון,6600,115,448,4,444
חולון,6600,116,241,3,238
חולון,6600,117,305,4,301
חולון,6600,118,363,2,361
חולון,6600,119,365,5,360
חולון,6600,120,355,5,350
חולון,6600,121,392,2,390
חולון,6600,122,362,3,359
חולון,6600,123,390,8,382
חולון,6600,124,450,5,445
חולון,6600,125,356,2,354
חולון,6600,126,326,7,319
חולון,6600,127,323,3,320
חולון,6600,128,343,6,337
חולון,6600,129,531,3,528
חולון,6600,130,523,2,521
חולון,6600,131,303,3,300
חולון,6600,132,422,0,422
חולון,6600,133,237,2,235
חולון,6600,134,366,4,362
חולון,6600,135,333,6,327
חולון,6600,136,391,6,385
חולון,6600,137,324,4,320
חולון,6600,138,418,11,407
חולון,6600,139,384,6,378
חולון,6600,140,413,5,408
חולון,6600,141,486,4,482
חולון,6600,142,325,7,318
חולון,6600,143,359,7,352
חולון,6600,144,487,4,483
חולון,6600,145,290,4,286
חולון,6600,146,373,6,367
חולון,6600,147,334,3,331
חולון,6600,148,407,8,399
חולון,6600,149,394,3,391
חולון,6600,150,387,2,385
חולון,6600,151,371,4,367
חולון,6600,152,426,16,410
חולון,6600,153,503,9,494
חולון,6600,154,390,1,389
חולון,6600,155,509,0,509
חולון,6600,156,499,5,494
חולון,6600,157,535,3,532
חולון,6600,158,392,2,390
חולון,6600,159,305,8,297
חולון,6600,160,394,0,394
חולון,6600,161,413,2,411
חולון,6600,162,466,3,463
חולון,6600,163,382,5,377
חולון,6600,164,384,6,378
חולון,6600,165,397,8,389
חולון,6600,166,414,3,411
חולון,6600,167,404,0,404
חולון,6600,168,393,4,389
חולון,6600,169,401,2,399
חולון,6600,170,511,1,510
חולון,6600,171,527,5,522
חולון,6600,172,403,3,400
חולון,6600,173,510,3,507
חולון,6600,174,461,4,457
חולון,6600,175,552,4,548
חולון,6600,176,418,2,416
חולון,6600,177,368,5,363
חולון,6600,178,353,2,351
חולון,6600,179,338,3,335
חולון,6600,180,349,3,346
חולון,6600,181,283,5,278
חולון,6600,182,516,13,503
חולון,6600,183,445,11,434
חולון,6600,184,466,4,462
חולון,6600,185,296,5,291
חולון,6600,186,475,11,464
חולון,6600,187,418,0,418
חולון,6600,188,577,2,575
חולון,6600,189,553,2,551
חולון,6600,190,336,2,334
חולון,6600,191,380,8,372
חולון,6600,192,411,8,403
חולון,6600,193,362,6,356
חולון,6600,194,354,3,351
חולון,6600,195,341,3,338
חולון,6600,197,371,4,367
חולון,6600,198,354,2,352
חולון,6600,199,294,0,294
חולון,6600,200,489,9,480
חולון,6600,201,260,6,254
חולון,6600,201,224,4,220
חולון,6600,202,510,2,508
חולון,6600,203,305,2,303
חולון,6600,204,278,2,276
חולון,6600,205,410,3,407
חולון,6600,206,370,2,368
חולון,6600,207,398,0,398
חולון,6600,208,546,3,543
חולון,6600,209,368,5,363
חולון,6600,210,357,2,355
חולון,6600,211,321,12,309
חולון,6600,212,484,9,475
חולון,6600,213,611,6,605
חולון,6600,214,278,1,277
חולון,6600,215,394,3,391
חולון,6600,216,458,3,455
חולון,6600,217,574,1,573
חולון,6600,218,444,0,444
חולון,6600,219,490,1,489
חולון,6600,220,490,6,484
חולון,6600,221,409,4,405
חולון,6600,222,590,6,584
חולון,6600,223,242,1,241
חולון,6600,224,477,4,473
חולון,6600,225,357,4,353
חולון,6600,226,492,7,485
חולון,6600,227,414,9,405
חולון,6600,228,242,4,238
חולון,6600,229,488,4,484
חולון,6600,230,296,5,291
חולון,6600,231,246,7,239
חולון,6600,232,328,1,327
חולון,6600,233,351,2,349
חולון,6600,234,323,4,319
חולון,6600,235,519,7,512
חולון,6600,236,377,3,374
חולון,6600,237,298,7,291
חולון,6600,238,270,3,267
חולון,6600,239,342,4,338
חולון,6600,240,467,2,465
חולון,6600,241,444,1,443
חולון,6600,242,328,8,320
חולון,6600,243,587,1,586
חולון,6600,244,364,3,361
חולון,6600,245,463,5,458
חולון,6600,246,325,5,320
חולון,6600,247,455,1,454
חולון,6600,248,516,3,513
חולון,6600,249,406,6,400
חולון,6600,251,423,1,422
חולון,6600,252,474,1,473
חולון,6600,253,509,2,507
חולון,6600,254,659,5,654
חולון,6600,255,550,0,550
חולון,6600,256,571,3,568
חולון,6600,257,302,1,301
חולון,6600,258,429,5,424
חולון,6600,259,549,3,546
חולון,6600,260,344,1,343
חולון,6600,953,505,5,500
חולון,6600,955,498,2,496
חולון,6600,957,418,3,415
חולית,1239,1,81,0,81
חולתה,253,1,297,1,296
חוסן,662,1,494,2,492
חוסנייה,1332,1,271,8,263
חופית,115,1,245,1,244
חופית,115,2,307,0,307
חוקוק,374,1,282,2,280
חורה,1303,1,332,3,329
חורה,1303,2,420,0,420
חורה,1303,3,249,3,246
חורה,1303,3,98,0,98
חורה,1303,4,372,8,364
חורה,1303,5,311,2,309
חורה,1303,6,254,3,251
חורה,1303,7,249,2,247
חורה,1303,8,480,2,478
חורה,1303,9,323,1,322
חורפיש,496,1,306,7,299
חורפיש,496,2,371,3,368
חורפיש,496,3,386,2,384
חורפיש,496,4,369,2,367
חורפיש,496,5,372,0,372
חורפיש,496,6,356,1,355
חורשים,355,1,184,0,184
חזון,1047,1,215,1,214
חיבת ציון,219,1,348,4,344
חיננית,3643,1,506,4,502
חיפה,4000,13,528,2,526
חיפה,4000,14,383,13,370
חיפה,4000,15,396,6,390
חיפה,4000,31,620,4,616
חיפה,4000,32,511,0,511
חיפה,4000,33,584,5,579
חיפה,4000,34,397,4,393
חיפה,4000,37,406,1,405
חיפה,4000,50,269,1,268
חיפה,4000,52,309,8,301
חיפה,4000,54,160,1,159
חיפה,4000,55,169,3,166
חיפה,4000,57,129,3,126
חיפה,4000,58,59,0,59
חיפה,4000,71,359,3,356
חיפה,4000,72,260,8,252
חיפה,4000,74,265,6,259
חיפה,4000,75,413,5,408
חיפה,4000,77,366,7,359
חיפה,4000,79,262,4,258
חיפה,4000,80,288,1,287
חיפה,4000,81,403,4,399
חיפה,4000,83,262,2,260
חיפה,4000,85,379,9,370
חיפה,4000,86,333,1,332
חיפה,4000,87,383,12,371
חיפה,4000,88,351,6,345
חיפה,4000,89,477,15,462
חיפה,4000,90,149,5,144
חיפה,4000,93,416,7,409
חיפה,4000,96,323,5,318
חיפה,4000,101,212,3,209
חיפה,4000,120,350,9,341
חיפה,4000,121,361,5,356
חיפה,4000,122,341,8,333
חיפה,4000,123,300,11,289
חיפה,4000,124,414,13,401
חיפה,4000,125,281,10,271
חיפה,4000,126,373,3,370
חיפה,4000,127,412,12,400
חיפה,4000,128,353,10,343
חיפה,4000,129,432,5,427
חיפה,4000,130,303,7,296
חיפה,4000,131,257,4,253
חיפה,4000,132,437,3,434
חיפה,4000,133,352,7,345
חיפה,4000,134,344,6,338
חיפה,4000,135,240,4,236
חיפה,4000,136,308,5,303
חיפה,4000,137,401,12,389
חיפה,4000,138,210,3,207
חיפה,4000,139,304,5,299
חיפה,4000,140,352,3,349
חיפה,4000,141,317,7,310
חיפה,4000,142,308,2,306
חיפה,4000,143,264,6,258
חיפה,4000,144,388,16,372
חיפה,4000,145,190,3,187
חיפה,4000,146,345,12,333
חיפה,4000,147,305,3,302
חיפה,4000,148,423,4,419
חיפה,4000,149,361,2,359
חיפה,4000,150,392,7,385
חיפה,4000,151,369,9,360
חיפה,4000,152,357,13,344
חיפה,4000,153,266,10,256
חיפה,4000,154,374,6,368
חיפה,4000,155,308,6,302
חיפה,4000,156,396,9,387
חיפה,4000,157,259,13,246
חיפה,4000,158,264,2,262
חיפה,4000,159,272,7,265
חיפה,4000,160,378,8,370
חיפה,4000,161,325,5,320
חיפה,4000,162,356,9,347
חיפה,4000,163,376,9,367
חיפה,4000,164,370,6,364
חיפה,4000,165,277,6,271
חיפה,4000,166,376,1,375
חיפה,4000,167,355,8,347
חיפה,4000,168,360,6,354
חיפה,4000,169,510,2,508
חיפה,4000,170,484,1,483
חיפה,4000,171,597,1,596
חיפה,4000,172,309,2,307
חיפה,4000,173,473,2,471
חיפה,4000,174,504,0,504
חיפה,4000,175,464,0,464
חיפה,4000,176,436,4,432
חיפה,4000,177,526,0,526
חיפה,4000,178,442,7,435
חיפה,4000,179,378,2,376
חיפה,4000,180,327,3,324
חיפה,4000,181,511,5,506
חיפה,4000,182,493,9,484
חיפה,4000,183,462,1,461
חיפה,4000,184,450,0,450
חיפה,4000,185,445,1,444
חיפה,4000,186,368,10,358
חיפה,4000,187,361,1,360
חיפה,4000,188,497,3,494
חיפה,4000,189,515,2,513
חיפה,4000,190,453,3,450
חיפה,4000,191,428,0,428
חיפה,4000,192,455,1,454
חיפה,4000,193,484,1,483
חיפה,4000,194,390,1,389
חיפה,4000,195,326,2,324
חיפה,4000,196,416,11,405
חיפה,4000,197,533,2,531
חיפה,4000,198,284,1,283
חיפה,4000,199,449,1,448
חיפה,4000,200,340,0,340
חיפה,4000,201,499,1,498
חיפה,4000,202,402,2,400
חיפה,4000,203,315,3,312
חיפה,4000,204,426,5,421
חיפה,4000,205,389,5,384
חיפה,4000,206,468,7,461
חיפה,4000,207,476,4,472
חיפה,4000,208,430,3,427
חיפה,4000,209,478,3,475
חיפה,4000,210,399,1,398
חיפה,4000,211,489,1,488
חיפה,4000,212,479,2,477
חיפה,4000,213,526,4,522
חיפה,4000,214,310,0,310
חיפה,4000,215,438,1,437
חיפה,4000,216,357,2,355
חיפה,4000,217,474,5,469
חיפה,4000,218,603,2,601
חיפה,4000,219,336,3,333
חיפה,4000,220,358,8,350
חיפה,4000,221,436,4,432
חיפה,4000,222,478,2,476
חיפה,4000,223,423,1,422
חיפה,4000,224,426,8,418
חיפה,4000,225,379,2,377
חיפה,4000,226,464,3,461
חיפה,4000,227,311,12,299
חיפה,4000,228,282,2,280
חיפה,4000,229,345,6,339
חיפה,4000,230,413,1,412
חיפה,4000,231,416,6,410
חיפה,4000,232,481,2,479
חיפה,4000,233,455,4,451
חיפה,4000,234,418,4,414
חיפה,4000,235,397,7,390
חיפה,4000,236,460,4,456
חיפה,4000,237,305,9,296
חיפה,4000,238,345,4,341
חיפה,4000,239,498,2,496
חיפה,4000,240,459,3,456
חיפה,4000,241,455,4,451
חיפה,4000,242,484,4,480
חיפה,4000,243,432,5,427
חיפה,4000,244,338,7,331
חיפה,4000,245,300,6,294
חיפה,4000,246,441,2,439
חיפה,4000,247,524,27,497
חיפה,4000,248,400,3,397
חיפה,4000,249,465,3,462
חיפה,4000,250,520,3,517
חיפה,4000,251,478,3,475
חיפה,4000,252,379,4,375
חיפה,4000,253,568,5,563
חיפה,4000,254,431,1,430
חיפה,4000,255,440,11,429
חיפה,4000,256,386,2,384
חיפה,4000,257,388,4,384
חיפה,4000,258,456,0,456
חיפה,4000,259,316,6,310
חיפה,4000,260,370,3,367
חיפה,4000,261,334,8,326
חיפה,4000,262,359,4,355
חיפה,4000,263,436,5,431
חיפה,4000,264,226,3,223
חיפה,4000,265,434,0,434
חיפה,4000,266,336,3,333
חיפה,4000,267,222,5,217
חיפה,4000,268,294,5,289
חיפה,4000,269,498,0,498
חיפה,4000,270,230,4,226
חיפה,4000,271,478,3,475
חיפה,4000,272,425,1,424
חיפה,4000,273,339,1,338
חיפה,4000,274,369,4,365
חיפה,4000,275,276,2,274
חיפה,4000,276,421,3,418
חיפה,4000,277,267,2,265
חיפה,4000,278,422,3,419
חיפה,4000,279,297,2,295
חיפה,4000,280,249,7,242
חיפה,4000,281,338,5,333
חיפה,4000,282,316,4,312
חיפה,4000,283,254,0,254
חיפה,4000,284,257,1,256
חיפה,4000,285,363,6,357
חיפה,4000,286,266,3,263
חיפה,4000,287,310,5,305
חיפה,4000,288,247,4,243
חיפה,4000,289,298,6,292
חיפה,4000,290,361,18,343
חיפה,4000,291,289,7,282
חיפה,4000,292,207,3,204
חיפה,4000,293,216,8,208
חיפה,4000,294,290,10,280
חיפה,4000,295,204,2,202
חיפה,4000,296,257,6,251
חיפה,4000,297,270,2,268
חיפה,4000,298,361,6,355
חיפה,4000,299,255,8,247
חיפה,4000,301,352,10,342
חיפה,4000,302,324,1,323
חיפה,4000,303,228,6,222
חיפה,4000,304,246,14,232
חיפה,4000,305,160,4,156
חיפה,4000,306,132,1,131
חיפה,4000,307,209,4,205
חיפה,4000,308,172,3,169
חיפה,4000,309,366,0,366
חיפה,4000,310,293,10,283
חיפה,4000,311,314,7,307
חיפה,4000,313,460,4,456
חיפה,4000,314,389,8,381
חיפה,4000,315,205,6,199
חיפה,4000,316,377,7,370
חיפה,4000,317,220,3,217
חיפה,4000,318,373,16,357
חיפה,4000,319,380,1,379
חיפה,4000,320,261,4,257
חיפה,4000,321,384,6,378
חיפה,4000,322,332,6,326
חיפה,4000,323,396,3,393
חיפה,4000,324,250,6,244
חיפה,4000,325,342,5,337
חיפה,4000,326,349,3,346
חיפה,4000,327,273,9,264
חיפה,4000,328,368,10,358
חיפה,4000,329,485,1,484
חיפה,4000,330,308,3,305
חיפה,4000,331,453,5,448
חיפה,4000,332,317,8,309
חיפה,4000,333,449,4,445
חיפה,4000,334,332,2,330
חיפה,4000,335,263,7,256
חיפה,4000,336,178,3,175
חיפה,4000,337,220,8,212
חיפה,4000,338,168,3,165
חיפה,4000,339,303,8,295
חיפה,4000,340,340,5,335
חיפה,4000,341,503,4,499
חיפה,4000,342,252,10,242
חיפה,4000,343,446,0,446
חיפה,4000,344,186,6,180
חיפה,4000,345,364,4,360
חיפה,4000,346,319,1,318
חיפה,4000,347,250,5,245
חיפה,4000,348,376,8,368
חיפה,4000,349,277,2,275
חיפה,4000,350,412,0,412
חיפה,4000,351,244,3,241
חיפה,4000,352,389,5,384
חיפה,4000,353,309,8,301
חיפה,4000,354,457,1,456
חיפה,4000,355,437,3,434
חיפה,4000,356,461,11,450
חיפה,4000,357,536,4,532
חיפה,4000,358,555,4,551
חיפה,4000,359,438,3,435
חיפה,4000,360,388,0,388
חיפה,4000,361,292,3,289
חיפה,4000,362,494,3,491
חיפה,4000,363,431,1,430
חיפה,4000,364,443,1,442
חיפה,4000,365,365,10,355
חיפה,4000,366,339,0,339
חיפה,4000,367,203,2,201
חיפה,4000,368,562,5,557
חיפה,4000,369,543,6,537
חיפה,4000,370,493,3,490
חיפה,4000,371,501,0,501
חיפה,4000,372,556,1,555
חיפה,4000,373,362,2,360
חיפה,4000,373,286,0,286
חיפה,4000,374,222,6,216
חיפה,4000,375,328,6,322
חיפה,4000,376,273,2,271
חיפה,4000,377,332,10,322
חיפה,4000,378,441,2,439
חיפה,4000,379,314,6,308
חיפה,4000,380,248,2,246
חיפה,4000,381,280,6,274
חיפה,4000,382,288,3,285
חיפה,4000,383,347,6,341
חיפה,4000,384,234,3,231
חיפה,4000,385,354,4,350
חיפה,4000,386,257,13,244
חיפה,4000,387,253,7,246
חיפה,4000,388,247,2,245
חיפה,4000,389,294,3,291
חיפה,4000,390,339,6,333
חיפה,4000,391,264,6,258
חיפה,4000,392,296,2,294
חיפה,4000,393,412,1,411
חיפה,4000,394,416,4,412
חיפה,4000,395,234,0,234
חיפה,4000,396,407,5,402
חיפה,4000,397,485,6,479
חיפה,4000,398,337,0,337
חיפה,4000,399,236,0,236
חיפה,4000,399,205,0,205
חיפה,4000,400,470,5,465
חיפה,4000,401,339,7,332
חיפה,4000,402,379,8,371
חיפה,4000,403,281,1,280
חיפה,4000,404,344,1,343
חיפה,4000,405,370,5,365
חיפה,4000,406,363,4,359
חיפה,4000,407,363,1,362
חיפה,4000,408,270,6,264
חיפה,4000,409,470,1,469
חיפה,4000,410,367,1,366
חיפה,4000,411,156,3,153
חיפה,4000,412,320,9,311
חיפה,4000,413,210,0,210
חיפה,4000,414,495,8,487
חיפה,4000,415,318,4,314
חיפה,4000,416,497,1,496
חיפה,4000,417,304,2,302
חיפה,4000,418,385,4,381
חיפה,4000,419,275,3,272
חיפה,4000,420,186,5,181
חיפה,4000,421,410,4,406
חיפה,4000,422,396,9,387
חיפה,4000,423,223,4,219
חיפה,4000,424,308,3,305
חיפה,4000,425,468,0,468
חיפה,4000,426,474,1,473
חיפה,4000,427,470,1,469
חיפה,4000,428,542,6,536
חיפה,4000,429,471,5,466
חיפה,4000,430,259,4,255
חיפה,4000,431,295,2,293
חיפה,4000,432,326,5,321
חיפה,4000,433,241,4,237
חיפה,4000,434,559,0,559
חיפה,4000,435,294,3,291
חיפה,4000,436,329,2,327
חיפה,4000,437,316,1,315
חיפה,4000,438,401,0,401
חיפה,4000,445,399,2,397
חיפה,4000,446,310,1,309
חיפה,4000,449,346,3,343
חיפה,4000,450,524,4,520
חיפה,4000,451,438,2,436
חיפה,4000,452,405,0,405
חיפה,4000,453,508,2,506
חיפה,4000,454,472,2,470
חיפה,4000,455,338,0,338
חיפה,4000,460,400,1,399
חיפה,4000,461,445,6,439
חיפה,4000,462,376,0,376
חיפה,4000,463,497,1,496
חיפה,4000,464,324,2,322
חיפה,4000,465,423,1,422
חיפה,4000,466,288,2,286
חיפה,4000,701,343,8,335
חיפה,4000,702,301,4,297
חיפה,4000,703,346,1,345
חיפה,4000,704,284,7,277
חיפה,4000,705,348,6,342
חיפה,4000,706,457,7,450
חיפה,4000,707,298,10,288
חיפה,4000,708,316,4,312
חיפה,4000,711,314,5,309
חיפה,4000,712,318,4,314
חיפה,4000,713,322,5,317
חיפה,4000,714,402,7,395
חיפה,4000,715,304,4,300
חיפה,4000,716,408,3,405
חיפה,4000,717,347,1,346
חיפה,4000,720,504,3,501
חיפה,4000,721,299,2,297
חיפה,4000,722,299,3,296
חיפה,4000,723,601,2,599
חיפה,4000,724,498,1,497
חיפה,4000,725,341,2,339
חיפה,4000,726,384,11,373
חיפה,4000,727,326,9,317
חיפה,4000,728,396,5,391
חיפה,4000,729,439,1,438
חיפה,4000,730,286,0,286
חיפה,4000,731,495,2,493
חיפה,4000,732,570,3,567
חיפה,4000,733,487,1,486
חיפה,4000,734,287,3,284
חיפה,4000,735,395,4,391
חיפה,4000,736,434,0,434
חיפה,4000,737,499,2,497
חיפה,4000,738,580,4,576
חיפה,4000,739,323,2,321
חיפה,4000,740,477,2,475
חיפה,4000,741,523,12,511
חיפה,4000,742,500,1,499
חיפה,4000,743,409,1,408
חיפה,4000,744,541,2,539
חיפה,4000,745,366,0,366
חיפה,4000,746,380,2,378
חיפה,4000,958,417,0,417
חיפה,4000,960,106,0,106
חיפה,4000,961,364,0,364
חיפה,4000,963,392,3,389
חירות,162,1,336,0,336
חירות,162,2,379,1,378
חלוץ,1272,1,232,1,231
חלמיש,3573,1,631,2,629
חלץ,820,1,253,5,248
חמאם,993,1,285,3,282
חמאם,993,2,225,6,219
חמד,801,1,453,0,453
חמדיה,343,1,227,1,226
חמרה,3609,1,93,0,93
חניאל,807,1,220,0,220
חניאל,807,2,263,1,262
חניתה,280,1,457,1,456
חנתון,1257,1,334,2,332
חספין,4005,1,576,0,576
חפץ חיים,363,1,282,1,281
חפצי-בה,90,1,306,3,303
חצב,700,1,266,4,262
חצב,700,2,355,0,355
חצבה,13,1,362,0,362
חצור הגלילית,2034,1,353,2,351
חצור הגלילית,2034,2,558,3,555
חצור הגלילית,2034,3,589,0,589
חצור הגלילית,2034,4,388,2,386
חצור הגלילית,2034,5,398,9,389
חצור הגלילית,2034,6,347,4,343
חצור הגלילית,2034,7,462,5,457
חצור הגלילית,2034,8,472,6,466
חצור הגלילית,2034,9,433,7,426
חצור הגלילית,2034,10,517,1,516
חצור הגלילית,2034,11,397,2,395
חצור-אשדוד,406,1,220,1,219
חצור-אשדוד,406,2,227,0,227
חצרים,397,1,289,0,289
חצרים,397,2,297,0,297
חרב לאת,422,1,420,5,415
חרוצים,1024,1,447,0,447
חריש,1247,1,415,2,413
חרמש,3717,1,122,1,121
חרשים,1209,1,143,0,143
חשמונאים,3770,1,600,0,600
חשמונאים,3770,2,547,3,544
חשמונאים,3770,3,594,2,592
טבריה,6700,1,397,7,390
טבריה,6700,2,343,4,339
טבריה,6700,3,399,3,396
טבריה,6700,4,391,2,389
טבריה,6700,5,387,5,382
טבריה,6700,6,460,3,457
טבריה,6700,7,487,9,478
טבריה,6700,8,357,0,357
טבריה,6700,9,302,3,299
טבריה,6700,10,476,5,471
טבריה,6700,11,317,1,316
טבריה,6700,12,170,5,165
טבריה,6700,13,236,0,236
טבריה,6700,14,442,4,438
טבריה,6700,15,366,4,362
טבריה,6700,16,299,7,292
טבריה,6700,17,454,6,448
טבריה,6700,18,422,3,419
טבריה,6700,19,366,4,362
טבריה,6700,20,247,0,247
טבריה,6700,21,337,3,334
טבריה,6700,22,441,8,433
טבריה,6700,23,254,1,253
טבריה,6700,24,239,0,239
טבריה,6700,25,307,2,305
טבריה,6700,26,257,3,254
טבריה,6700,27,326,3,323
טבריה,6700,28,215,1,214
טבריה,6700,29,328,3,325
טבריה,6700,30,472,3,469
טבריה,6700,31,376,3,373
טבריה,6700,32,358,6,352
טבריה,6700,33,320,2,318
טבריה,6700,34,328,0,328
טבריה,6700,35,345,8,337
טבריה,6700,36,295,0,295
טבריה,6700,37,403,2,401
טבריה,6700,38,363,4,359
טבריה,6700,39,390,1,389
טבריה,6700,40,397,8,389
טבריה,6700,41,354,2,352
טבריה,6700,42,306,4,302
טבריה,6700,43,437,3,434
טבריה,6700,44,372,6,366
טבריה,6700,45,261,3,258
טבריה,6700,46,399,5,394
טבריה,6700,47,427,5,422
טבריה,6700,48,330,5,325
טבריה,6700,49,407,6,401
טבריה,6700,50,411,1,410
טבריה,6700,51,347,1,346
טבריה,6700,52,401,2,399
טבריה,6700,53,373,3,370
טבריה,6700,54,350,2,348
טבריה,6700,55,194,4,190
טבריה,6700,56,367,2,365
טבריה,6700,58,241,2,239
טבריה,6700,950,365,0,365
טובא-זנגריה,962,1,328,7,321
טובא-זנגריה,962,2,341,2,339
טובא-זנגריה,962,3,318,4,314
טובא-זנגריה,962,4,255,2,253
טובא-זנגריה,962,5,291,6,285
טובא-זנגריה,962,6,271,3,268
טורעאן,498,1,435,5,430
טורעאן,498,2,428,4,424
טורעאן,498,3,482,3,479
טורעאן,498,4,497,3,494
טורעאן,498,5,428,4,424
טורעאן,498,6,363,6,357
טורעאן,498,7,433,3,430
טורעאן,498,8,396,3,393
טורעאן,498,9,423,4,419
טורעאן,498,10,468,3,465
טורעאן,498,11,457,5,452
טורעאן,498,12,511,5,506
טייבה (בעמק),497,1,334,4,330
טייבה (בעמק),497,2,291,2,289
טייבה,2730,1,499,2,497
טייבה,2730,2,392,1,391
טייבה,2730,3,484,7,477
טייבה,2730,4,462,1,461
טייבה,2730,5,420,2,418
טייבה,2730,6,432,5,427
טייבה,2730,7,459,0,459
טייבה,2730,8,516,2,514
טייבה,2730,9,459,4,455
טייבה,2730,10,469,4,465
טייבה,2730,11,481,3,478
טייבה,2730,12,471,4,467
טייבה,2730,13,469,2,467
טייבה,2730,14,538,4,534
טייבה,2730,15,544,6,538
טייבה,2730,16,544,2,542
טייבה,2730,17,516,8,508
טייבה,2730,18,493,5,488
טייבה,2730,19,513,4,509
טייבה,2730,20,527,1,526
טייבה,2730,21,522,1,521
טייבה,2730,22,444,3,441
טייבה,2730,23,476,0,476
טייבה,2730,24,485,4,481
טייבה,2730,25,455,9,446
טייבה,2730,26,418,3,415
טייבה,2730,27,494,2,492
טייבה,2730,28,475,6,469
טייבה,2730,29,526,4,522
טייבה,2730,30,478,5,473
טייבה,2730,31,500,6,494
טייבה,2730,32,544,1,543
טייבה,2730,33,562,4,558
טייבה,2730,34,455,5,450
טייבה,2730,35,508,4,504
טייבה,2730,36,529,10,519
טייבה,2730,37,544,4,540
טירה,2720,1,482,3,479
טירה,2720,2,498,2,496
טירה,2720,3,490,3,487
טירה,2720,4,499,2,497
טירה,2720,5,528,2,526
טירה,2720,6,528,4,524
טירה,2720,7,532,1,531
טירה,2720,8,476,2,474
טירה,2720,9,514,3,511
טירה,2720,10,526,1,525
טירה,2720,11,527,1,526
טירה,2720,12,513,2,511
טירה,2720,13,512,5,507
טירה,2720,14,487,1,486
טירה,2720,15,517,11,506
טירה,2720,16,552,2,550
טירה,2720,17,508,5,503
טירה,2720,18,519,4,515
טירה,2720,19,515,3,512
טירה,2720,20,524,1,523
טירה,2720,21,477,0,477
טירה,2720,22,467,6,461
טירה,2720,23,491,7,484
טירת יהודה,663,1,609,1,608
טירת כרמל,2100,1,441,8,433
טירת כרמל,2100,4,387,0,387
טירת כרמל,2100,6,577,6,571
טירת כרמל,2100,7,535,13,522
טירת כרמל,2100,8,504,2,502
טירת כרמל,2100,9,395,3,392
טירת כרמל,2100,10,309,3,306
טירת כרמל,2100,11,470,2,468
טירת כרמל,2100,12,410,6,404
טירת כרמל,2100,13,378,7,371
טירת כרמל,2100,14,396,10,386
טירת כרמל,2100,15,326,4,322
טירת כרמל,2100,16,359,4,355
טירת כרמל,2100,17,391,6,385
טירת כרמל,2100,18,357,43,314
טירת כרמל,2100,20,298,2,296
טירת כרמל,2100,21,410,3,407
טירת כרמל,2100,22,473,4,469
טירת כרמל,2100,23,362,8,354
טירת כרמל,2100,24,505,3,502
טירת כרמל,2100,25,542,2,540
טירת כרמל,2100,26,453,1,452
טירת כרמל,2100,27,401,7,394
טירת כרמל,2100,30,322,2,320
טירת כרמל,2100,31,365,8,357
טירת כרמל,2100,950,369,1,368
טירת צבי,268,1,417,2,415
טל שחר,462,1,568,0,568
טל-אל,1181,1,612,4,608
טללים,1177,1,143,2,141
טלמון,3788,1,380,2,378
טלמון,3788,1,327,0,327
טלמון,3788,2,653,1,652
טמרה (יזרעאל),547,1,383,0,383
טמרה (יזרעאל),547,2,336,2,334
טמרה,8900,1,615,3,612
טמרה,8900,2,537,0,537
טמרה,8900,3,559,3,556
טמרה,8900,4,494,0,494
טמרה,8900,5,703,0,703
טמרה,8900,6,490,7,483
טמרה,8900,7,636,0,636
טמרה,8900,8,562,1,561
טמרה,8900,9,462,2,460
טמרה,8900,10,642,0,642
טמרה,8900,11,539,1,538
טמרה,8900,12,577,3,574
טמרה,8900,13,631,6,625
טמרה,8900,14,600,2,598
טמרה,8900,15,538,10,528
טמרה,8900,16,491,4,487
טמרה,8900,17,549,1,548
טמרה,8900,18,530,3,527
טמרה,8900,19,529,3,526
טמרה,8900,20,532,0,532
טמרה,8900,21,577,2,575
טמרה,8900,22,588,3,585
טמרה,8900,23,735,6,729
טמרה,8900,24,692,0,692
טמרה,8900,25,540,2,538
טמרה,8900,26,599,1,598
טמרה,8900,27,487,1,486
טמרה,8900,28,542,1,541
טנא,3743,1,363,1,362
טפחות,1214,1,188,0,188
יאנוח-ג'ת,1295,1,307,2,305
יאנוח-ג'ת,1295,2,371,1,370
יאנוח-ג'ת,1295,3,389,9,380
יאנוח-ג'ת,1295,4,393,7,386
יאנוח-ג'ת,1295,5,339,4,335
יאנוח-ג'ת,1295,6,367,1,366
יבול,1232,1,179,0,179
יבנאל,46,1,442,4,438
יבנאל,46,2,467,4,463
יבנאל,46,3,481,0,481
יבנאל,46,4,390,1,389
יבנה,2660,1,294,3,291
יבנה,2660,2,433,6,427
יבנה,2660,3,489,7,482
יבנה,2660,4,493,5,488
יבנה,2660,5,471,3,468
יבנה,2660,6,595,4,591
יבנה,2660,7,459,5,454
יבנה,2660,8,458,18,440
יבנה,2660,9,453,7,446
יבנה,2660,10,446,6,440
יבנה,2660,11,376,4,372
יבנה,2660,12,601,2,599
יבנה,2660,13,455,0,455
יבנה,2660,14,366,0,366
יבנה,2660,15,345,0,345
יבנה,2660,16,461,5,456
יבנה,2660,17,411,3,408
יבנה,2660,18,340,2,338
יבנה,2660,19,288,6,282
יבנה,2660,20,321,6,315
יבנה,2660,21,374,2,372
יבנה,2660,22,459,10,449
יבנה,2660,23,590,10,580
יבנה,2660,24,522,2,520
יבנה,2660,25,514,3,511
יבנה,2660,26,382,1,381
יבנה,2660,27,435,8,427
יבנה,2660,28,353,0,353
יבנה,2660,29,566,5,561
יבנה,2660,30,498,9,489
יבנה,2660,31,321,9,312
יבנה,2660,32,438,1,437
יבנה,2660,33,564,3,561
יבנה,2660,34,580,6,574
יבנה,2660,35,403,4,399
יבנה,2660,36,359,7,352
יבנה,2660,37,498,2,496
יבנה,2660,38,374,1,373
יבנה,2660,39,324,2,322
יבנה,2660,40,380,1,379
יבנה,2660,41,314,0,314
יבנה,2660,42,397,0,397
יבנה,2660,45,451,4,447
יבנה,2660,46,571,2,569
יבנה,2660,47,361,3,358
יבנה,2660,47,333,0,333
יבנה,2660,48,584,3,581
יבנה,2660,49,652,3,649
יבנה,2660,50,444,1,443
יבנה,2660,951,495,2,493
יגור,96,1,287,0,287
יגור,96,2,287,0,287
יגור,96,3,320,4,316
יגל,798,1,458,1,457
יד בנימין,577,1,577,2,575
יד בנימין,577,2,508,2,506
יד בנימין,577,3,401,4,397
יד חנה,758,1,392,1,391
יד מרדכי,358,1,239,0,239
יד מרדכי,358,2,238,0,238
יד נתן,775,1,295,1,294
"יד רמב""ם",64,1,302,2,300
"יד רמב""ם",64,2,310,2,308
יהוד-מונוסון,9400,1,285,1,284
יהוד-מונוסון,9400,2,499,3,496
יהוד-מונוסון,9400,3,400,3,397
יהוד-מונוסון,9400,4,522,5,517
יהוד-מונוסון,9400,5,263,1,262
יהוד-מונוסון,9400,6,518,5,513
יהוד-מונוסון,9400,7,500,1,499
יהוד-מונוסון,9400,8,426,5,421
יהוד-מונוסון,9400,9,353,1,352
יהוד-מונוסון,9400,10,346,2,344
יהוד-מונוסון,9400,11,269,3,266
יהוד-מונוסון,9400,12,316,4,312
יהוד-מונוסון,9400,13,415,2,413
יהוד-מונוסון,9400,14,456,12,444
יהוד-מונוסון,9400,15,303,1,302
יהוד-מונוסון,9400,16,243,1,242
יהוד-מונוסון,9400,17,537,6,531
יהוד-מונוסון,9400,18,476,2,474
יהוד-מונוסון,9400,19,526,1,525
יהוד-מונוסון,9400,20,422,4,418
יהוד-מונוסון,9400,21,576,1,575
יהוד-מונוסון,9400,22,436,1,435
יהוד-מונוסון,9400,23,475,3,472
יהוד-מונוסון,9400,24,360,3,357
יהוד-מונוסון,9400,25,466,0,466
יהוד-מונוסון,9400,26,424,0,424
יהוד-מונוסון,9400,27,501,0,501
יהוד-מונוסון,9400,28,406,1,405
יהוד-מונוסון,9400,29,483,6,477
יהוד-מונוסון,9400,30,290,1,289
יהוד-מונוסון,9400,31,478,1,477
יהוד-מונוסון,9400,33,327,4,323
יהוד-מונוסון,9400,35,390,3,387
יהוד-מונוסון,9400,36,304,3,301
יהוד-מונוסון,9400,37,520,4,516
יהוד-מונוסון,9400,38,348,0,348
יהוד-מונוסון,9400,101,574,1,573
יהוד-מונוסון,9400,102,399,1,398
יהוד-מונוסון,9400,103,485,13,472
יהוד-מונוסון,9400,104,408,2,406
יהל,1158,1,102,0,102
יובל,2009,1,354,0,354
יובלים,1226,1,415,0,415
יובלים,1226,2,363,1,362
יודפת,1112,1,374,1,373
יונתן,4007,1,234,1,233
יושיביה,803,1,240,1,239
יזרעאל,452,1,353,2,351
יחיעם,409,1,325,0,325
יטבתה,866,1,219,0,219
יטבתה,866,2,185,0,185
"ייט""ב",3607,1,138,1,137
יכיני,811,1,353,3,350
ינוב,753,1,460,0,460
ינון,2011,1,315,0,315
ינון,2011,2,318,0,318
יסוד המעלה,29,1,431,0,431
יסוד המעלה,29,2,426,2,424
יסודות,440,1,273,2,271
יסעור,575,1,312,1,311
יעד,1138,1,415,1,414
יעף,1044,1,124,0,124
יערה,795,1,378,0,378
יפיע,499,1,455,0,455
יפיע,499,2,446,9,437
יפיע,499,3,372,1,371
יפיע,499,4,461,1,460
יפיע,499,5,549,0,549
יפיע,499,6,438,6,432
יפיע,499,7,490,6,484
יפיע,499,8,412,6,406
יפיע,499,9,491,9,482
יפיע,499,10,447,11,436
יפיע,499,11,453,1,452
יפיע,499,12,444,2,442
יפיע,499,13,415,7,408
יפיע,499,14,414,0,414
יפיע,499,15,494,13,481
יפיע,499,16,356,7,349
יפיע,499,17,356,2,354
יפית,3566,1,82,0,82
יפעת,134,1,298,0,298
יפעת,134,2,254,0,254
יפתח,453,1,354,3,351
יצהר,3749,1,448,0,448
יציץ,759,1,396,4,392
יקום,417,1,408,1,407
יקיר,3647,1,598,1,597
יקיר,3647,2,228,1,227
יקנעם (מושבה),241,1,376,3,373
יקנעם (מושבה),241,2,385,1,384
יקנעם עילית,240,2,508,0,508
יקנעם עילית,240,3,502,7,495
יקנעם עילית,240,6,414,5,409
יקנעם עילית,240,7,451,6,445
יקנעם עילית,240,8,327,12,315
יקנעם עילית,240,9,432,10,422
יקנעם עילית,240,10,420,3,417
יקנעם עילית,240,11,351,11,340
יקנעם עילית,240,12,387,8,379
יקנעם עילית,240,13,456,8,448
יקנעם עילית,240,14,406,4,402
יקנעם עילית,240,15,386,1,385
יקנעם עילית,240,16,441,3,438
יקנעם עילית,240,17,515,4,511
יקנעם עילית,240,18,332,5,327
יקנעם עילית,240,20,495,2,493
יקנעם עילית,240,21,430,4,426
יקנעם עילית,240,22,564,3,561
יקנעם עילית,240,23,403,5,398
יקנעם עילית,240,24,391,7,384
יקנעם עילית,240,25,410,5,405
יקנעם עילית,240,26,356,3,353
יקנעם עילית,240,27,628,2,626
יקנעם עילית,240,28,520,5,515
יקנעם עילית,240,29,636,4,632
יראון,623,1,223,2,221
ירדנה,2026,1,198,3,195
ירוחם,831,1,513,22,491
ירוחם,831,2,427,11,416
ירוחם,831,3,324,9,315
ירוחם,831,4,299,10,289
ירוחם,831,5,355,7,348
ירוחם,831,6,479,4,475
ירוחם,831,7,299,7,292
ירוחם,831,8,329,4,325
ירוחם,831,9,508,5,503
ירוחם,831,10,285,6,279
ירוחם,831,11,391,3,388
ירושלים,3000,1,465,15,450
ירושלים,3000,2,302,7,295
ירושלים,3000,3,373,5,368
ירושלים,3000,4,455,4,451
ירושלים,3000,5,100,2,98
ירושלים,3000,5,68,1,67
ירושלים,3000,6,301,5,296
ירושלים,3000,7,333,15,318
ירושלים,3000,8,299,4,295
ירושלים,3000,9,387,4,383
ירושלים,3000,10,416,5,411
ירושלים,3000,11,399,2,397
ירושלים,3000,12,253,4,249
ירושלים,3000,13,249,0,249
ירושלים,3000,14,162,0,162
ירושלים,3000,14,132,0,132
ירושלים,3000,15,109,2,107
ירושלים,3000,15,75,0,75
ירושלים,3000,16,136,0,136
ירושלים,3000,16,69,0,69
ירושלים,3000,17,77,3,74
ירושלים,3000,17,38,0,38
ירושלים,3000,18,149,1,148
ירושלים,3000,19,429,3,426
ירושלים,3000,20,204,6,198
ירושלים,3000,21,434,9,425
ירושלים,3000,22,435,4,431
ירושלים,3000,23,319,12,307
ירושלים,3000,24,367,3,364
ירושלים,3000,25,413,10,403
ירושלים,3000,26,355,6,349
ירושלים,3000,27,521,8,513
ירושלים,3000,28,288,9,279
ירושלים,3000,28,232,3,229
ירושלים,3000,29,365,3,362
ירושלים,3000,30,96,0,96
ירושלים,3000,32,173,1,172
ירושלים,3000,41,119,4,115
ירושלים,3000,41,87,1,86
ירושלים,3000,42,235,0,235
ירושלים,3000,43,171,2,169
ירושלים,3000,43,126,2,124
ירושלים,3000,44,303,4,299
ירושלים,3000,45,363,8,355
ירושלים,3000,46,383,13,370
ירושלים,3000,47,405,5,400
ירושלים,3000,48,344,4,340
ירושלים,3000,49,499,1,498
ירושלים,3000,50,426,2,424
ירושלים,3000,51,502,5,497
ירושלים,3000,52,389,4,385
ירושלים,3000,53,265,5,260
ירושלים,3000,53,200,1,199
ירושלים,3000,54,340,4,336
ירושלים,3000,55,359,3,356
ירושלים,3000,56,273,2,271
ירושלים,3000,56,176,0,176
ירושלים,3000,57,332,5,327
ירושלים,3000,58,283,3,280
ירושלים,3000,59,484,10,474
ירושלים,3000,60,294,3,291
ירושלים,3000,61,276,5,271
ירושלים,3000,62,184,3,181
ירושלים,3000,63,431,15,416
ירושלים,3000,64,435,14,421
ירושלים,3000,65,342,22,320
ירושלים,3000,66,451,0,451
ירושלים,3000,67,194,0,194
ירושלים,3000,81,274,3,271
ירושלים,3000,82,161,2,159
ירושלים,3000,83,318,3,315
ירושלים,3000,84,349,8,341
ירושלים,3000,85,240,1,239
ירושלים,3000,86,286,2,284
ירושלים,3000,87,237,1,236
ירושלים,3000,88,266,2,264
ירושלים,3000,89,167,1,166
ירושלים,3000,90,245,2,243
ירושלים,3000,93,234,1,233
ירושלים,3000,94,188,0,188
ירושלים,3000,116,363,0,363
ירושלים,3000,117,280,3,277
ירושלים,3000,118,234,1,233
ירושלים,3000,119,284,3,281
ירושלים,3000,120,241,0,241
ירושלים,3000,131,238,3,235
ירושלים,3000,132,381,6,375
ירושלים,3000,133,270,56,214
ירושלים,3000,134,247,3,244
ירושלים,3000,135,342,3,339
ירושלים,3000,137,426,4,422
ירושלים,3000,149,420,0,420
ירושלים,3000,150,399,3,396
ירושלים,3000,151,367,2,365
ירושלים,3000,154,482,0,482
ירושלים,3000,155,333,0,333
ירושלים,3000,157,330,3,327
ירושלים,3000,158,313,3,310
ירושלים,3000,159,351,0,351
ירושלים,3000,161,246,0,246
ירושלים,3000,161,138,0,138
ירושלים,3000,162,358,0,358
ירושלים,3000,165,401,2,399
ירושלים,3000,171,308,9,299
ירושלים,3000,172,205,4,201
ירושלים,3000,186,401,2,399
ירושלים,3000,188,285,3,282
ירושלים,3000,191,275,0,275
ירושלים,3000,192,309,4,305
ירושלים,3000,193,222,4,218
ירושלים,3000,193,181,4,177
ירושלים,3000,194,278,2,276
ירושלים,3000,195,243,0,243
ירושלים,3000,196,440,2,438
ירושלים,3000,198,433,5,428
ירושלים,3000,200,445,1,444
ירושלים,3000,201,402,3,399
ירושלים,3000,203,424,3,421
ירושלים,3000,205,233,3,230
ירושלים,3000,206,407,4,403
ירושלים,3000,207,396,2,394
ירושלים,3000,208,238,4,234
ירושלים,3000,209,373,6,367
ירושלים,3000,209,255,6,249
ירושלים,3000,210,406,1,405
ירושלים,3000,211,374,2,372
ירושלים,3000,212,388,19,369
ירושלים,3000,213,416,2,414
ירושלים,3000,214,312,0,312
ירושלים,3000,215,323,5,318
ירושלים,3000,215,233,3,230
ירושלים,3000,216,515,1,514
ירושלים,3000,217,321,13,308
ירושלים,3000,218,386,10,376
ירושלים,3000,219,376,8,368
ירושלים,3000,220,287,10,277
ירושלים,3000,221,319,1,318
ירושלים,3000,221,213,0,213
ירושלים,3000,222,492,19,473
ירושלים,3000,223,340,9,331
ירושלים,3000,224,498,13,485
ירושלים,3000,225,292,6,286
ירושלים,3000,226,501,3,498
ירושלים,3000,227,454,2,452
ירושלים,3000,228,37,1,36
ירושלים,3000,229,506,9,497
ירושלים,3000,230,586,12,574
ירושלים,3000,231,469,0,469
ירושלים,3000,232,374,2,372
ירושלים,3000,233,445,10,435
ירושלים,3000,234,475,4,471
ירושלים,3000,235,445,4,441
ירושלים,3000,236,555,6,549
ירושלים,3000,237,478,9,469
ירושלים,3000,238,402,3,399
ירושלים,3000,239,342,19,323
ירושלים,3000,240,484,5,479
ירושלים,3000,241,388,17,371
ירושלים,3000,242,339,5,334
ירושלים,3000,243,415,26,389
ירושלים,3000,244,391,5,386
ירושלים,3000,245,392,21,371
ירושלים,3000,246,384,15,369
ירושלים,3000,247,431,29,402
ירושלים,3000,248,457,11,446
ירושלים,3000,249,526,18,508
ירושלים,3000,250,521,17,504
ירושלים,3000,251,490,9,481
ירושלים,3000,252,364,13,351
ירושלים,3000,253,444,9,435
ירושלים,3000,254,364,4,360
ירושלים,3000,255,416,9,407
ירושלים,3000,256,433,4,429
ירושלים,3000,257,449,1,448
ירושלים,3000,258,574,6,568
ירושלים,3000,259,509,5,504
ירושלים,3000,260,339,0,339
ירושלים,3000,261,376,3,373
ירושלים,3000,262,455,6,449
ירושלים,3000,263,436,4,432
ירושלים,3000,264,442,4,438
ירושלים,3000,265,477,10,467
ירושלים,3000,266,334,4,330
ירושלים,3000,267,197,0,197
ירושלים,3000,267,152,0,152
ירושלים,3000,268,418,2,416
ירושלים,3000,269,526,5,521
ירושלים,3000,270,507,2,505
ירושלים,3000,271,298,2,296
ירושלים,3000,272,584,4,580
ירושלים,3000,273,396,1,395
ירושלים,3000,274,470,1,469
ירושלים,3000,275,344,3,341
ירושלים,3000,276,460,3,457
ירושלים,3000,277,316,2,314
ירושלים,3000,278,524,6,518
ירושלים,3000,279,364,1,363
ירושלים,3000,280,416,9,407
ירושלים,3000,281,380,4,376
ירושלים,3000,282,448,2,446
ירושלים,3000,283,366,4,362
ירושלים,3000,284,459,2,457
ירושלים,3000,285,392,24,368
ירושלים,3000,286,425,3,422
ירושלים,3000,287,305,1,304
ירושלים,3000,287,273,11,262
ירושלים,3000,288,408,5,403
ירושלים,3000,289,556,24,532
ירושלים,3000,290,561,6,555
ירושלים,3000,291,423,9,414
ירושלים,3000,292,266,1,265
ירושלים,3000,293,389,16,373
ירושלים,3000,294,492,10,482
ירושלים,3000,295,442,4,438
ירושלים,3000,296,506,5,501
ירושלים,3000,297,390,3,387
ירושלים,3000,298,569,5,564
ירושלים,3000,299,505,2,503
ירושלים,3000,300,606,0,606
ירושלים,3000,301,500,4,496
ירושלים,3000,302,450,2,448
ירושלים,3000,303,366,9,357
ירושלים,3000,304,376,2,374
ירושלים,3000,305,323,1,322
ירושלים,3000,306,392,4,388
ירושלים,3000,307,403,3,400
ירושלים,3000,308,300,2,298
ירושלים,3000,309,461,3,458
ירושלים,3000,310,363,3,360
ירושלים,3000,311,409,0,409
ירושלים,3000,312,360,4,356
ירושלים,3000,313,360,2,358
ירושלים,3000,314,398,4,394
ירושלים,3000,315,501,14,487
ירושלים,3000,316,511,4,507
ירושלים,3000,317,303,2,301
ירושלים,3000,318,481,4,477
ירושלים,3000,319,540,3,537
ירושלים,3000,320,284,1,283
ירושלים,3000,321,384,2,382
ירושלים,3000,322,527,7,520
ירושלים,3000,323,470,7,463
ירושלים,3000,324,258,1,257
ירושלים,3000,325,506,7,499
ירושלים,3000,326,398,5,393
ירושלים,3000,327,392,6,386
ירושלים,3000,328,371,8,363
ירושלים,3000,329,459,2,457
ירושלים,3000,330,269,3,266
ירושלים,3000,331,344,1,343
ירושלים,3000,332,294,8,286
ירושלים,3000,332,224,3,221
ירושלים,3000,333,442,1,441
ירושלים,3000,334,310,13,297
ירושלים,3000,335,315,4,311
ירושלים,3000,336,359,0,359
ירושלים,3000,337,374,2,372
ירושלים,3000,338,435,1,434
ירושלים,3000,339,260,2,258
ירושלים,3000,340,336,1,335
ירושלים,3000,341,366,2,364
ירושלים,3000,342,330,3,327
ירושלים,3000,343,454,5,449
ירושלים,3000,344,376,1,375
ירושלים,3000,345,414,0,414
ירושלים,3000,346,522,1,521
ירושלים,3000,347,324,2,322
ירושלים,3000,348,413,3,410
ירושלים,3000,349,341,2,339
ירושלים,3000,350,416,8,408
ירושלים,3000,351,400,0,400
ירושלים,3000,352,423,4,419
ירושלים,3000,353,510,3,507
ירושלים,3000,354,453,7,446
ירושלים,3000,355,410,2,408
ירושלים,3000,356,450,2,448
ירושלים,3000,357,454,5,449
ירושלים,3000,358,300,0,300
ירושלים,3000,359,400,1,399
ירושלים,3000,360,357,4,353
ירושלים,3000,361,547,3,544
ירושלים,3000,362,492,6,486
ירושלים,3000,363,443,6,437
ירושלים,3000,364,336,4,332
ירושלים,3000,365,440,5,435
ירושלים,3000,366,315,3,312
ירושלים,3000,367,471,6,465
ירושלים,3000,368,409,8,401
ירושלים,3000,369,276,3,273
ירושלים,3000,370,383,3,380
ירושלים,3000,371,318,0,318
ירושלים,3000,371,245,1,244
ירושלים,3000,372,441,3,438
ירושלים,3000,373,328,5,323
ירושלים,3000,374,381,4,377
ירושלים,3000,375,569,4,565
ירושלים,3000,376,394,2,392
ירושלים,3000,377,490,2,488
ירושלים,3000,378,411,1,410
ירושלים,3000,379,493,5,488
ירושלים,3000,380,515,2,513
ירושלים,3000,381,342,4,338
ירושלים,3000,382,379,2,377
ירושלים,3000,383,442,5,437
ירושלים,3000,384,325,3,322
ירושלים,3000,385,455,1,454
ירושלים,3000,386,448,1,447
ירושלים,3000,387,410,3,407
ירושלים,3000,388,377,4,373
ירושלים,3000,389,392,2,390
ירושלים,3000,390,484,7,477
ירושלים,3000,391,333,3,330
ירושלים,3000,392,323,1,322
ירושלים,3000,393,425,3,422
ירושלים,3000,394,343,0,343
ירושלים,3000,395,281,3,278
ירושלים,3000,396,392,0,392
ירושלים,3000,397,244,1,243
ירושלים,3000,398,375,0,375
ירושלים,3000,399,561,5,556
ירושלים,3000,400,527,2,525
ירושלים,3000,401,323,0,323
ירושלים,3000,402,486,7,479
ירושלים,3000,403,524,2,522
ירושלים,3000,404,444,2,442
ירושלים,3000,405,418,2,416
ירושלים,3000,406,327,2,325
ירושלים,3000,407,338,1,337
ירושלים,3000,408,426,4,422
ירושלים,3000,409,421,5,416
ירושלים,3000,410,378,1,377
ירושלים,3000,411,460,0,460
ירושלים,3000,412,406,4,402
ירושלים,3000,413,358,2,356
ירושלים,3000,414,451,2,449
ירושלים,3000,415,404,2,402
ירושלים,3000,416,315,6,309
ירושלים,3000,417,428,16,412
ירושלים,3000,418,400,10,390
ירושלים,3000,420,402,11,391
ירושלים,3000,421,306,1,305
ירושלים,3000,422,329,4,325
ירושלים,3000,423,313,0,313
ירושלים,3000,424,536,10,526
ירושלים,3000,425,238,1,237
ירושלים,3000,426,362,6,356
ירושלים,3000,427,255,3,252
ירושלים,3000,428,380,4,376
ירושלים,3000,429,370,3,367
ירושלים,3000,430,408,2,406
ירושלים,3000,431,409,1,408
ירושלים,3000,432,449,2,447
ירושלים,3000,433,274,3,271
ירושלים,3000,434,475,5,470
ירושלים,3000,435,365,2,363
ירושלים,3000,436,247,3,244
ירושלים,3000,437,341,2,339
ירושלים,3000,438,409,4,405
ירושלים,3000,439,442,2,440
ירושלים,3000,440,435,8,427
ירושלים,3000,441,291,4,287
ירושלים,3000,442,486,7,479
ירושלים,3000,443,388,11,377
ירושלים,3000,444,340,1,339
ירושלים,3000,445,421,13,408
ירושלים,3000,450,521,11,510
ירושלים,3000,451,335,10,325
ירושלים,3000,452,274,7,267
ירושלים,3000,453,469,0,469
ירושלים,3000,456,276,1,275
ירושלים,3000,457,194,1,193
ירושלים,3000,458,174,1,173
ירושלים,3000,459,406,3,403
ירושלים,3000,460,450,2,448
ירושלים,3000,461,439,6,433
ירושלים,3000,462,336,4,332
ירושלים,3000,463,321,3,318
ירושלים,3000,464,408,2,406
ירושלים,3000,465,434,1,433
ירושלים,3000,466,185,1,184
ירושלים,3000,467,496,7,489
ירושלים,3000,468,511,2,509
ירושלים,3000,469,346,3,343
ירושלים,3000,470,437,10,427
ירושלים,3000,471,435,1,434
ירושלים,3000,472,458,2,456
ירושלים,3000,473,475,3,472
ירושלים,3000,474,325,0,325
ירושלים,3000,475,158,1,157
ירושלים,3000,476,152,0,152
ירושלים,3000,477,428,2,426
ירושלים,3000,478,325,4,321
ירושלים,3000,479,215,0,215
ירושלים,3000,480,442,3,439
ירושלים,3000,481,429,5,424
ירושלים,3000,482,324,0,324
ירושלים,3000,483,251,4,247
ירושלים,3000,484,472,6,466
ירושלים,3000,485,356,3,353
ירושלים,3000,486,483,16,467
ירושלים,3000,487,383,2,381
ירושלים,3000,488,406,25,381
ירושלים,3000,489,218,4,214
ירושלים,3000,490,423,3,420
ירושלים,3000,491,268,4,264
ירושלים,3000,496,160,5,155
ירושלים,3000,498,456,12,444
ירושלים,3000,499,265,13,252
ירושלים,3000,500,481,7,474
ירושלים,3000,503,165,4,161
ירושלים,3000,504,140,0,140
ירושלים,3000,505,156,4,152
ירושלים,3000,506,253,0,253
ירושלים,3000,507,370,2,368
ירושלים,3000,521,77,0,77
ירושלים,3000,530,470,2,468
ירושלים,3000,534,61,3,58
ירושלים,3000,535,79,1,78
ירושלים,3000,547,122,0,122
ירושלים,3000,550,392,8,384
ירושלים,3000,551,384,3,381
ירושלים,3000,552,321,16,305
ירושלים,3000,553,318,7,311
ירושלים,3000,554,389,19,370
ירושלים,3000,555,425,10,415
ירושלים,3000,556,322,3,319
ירושלים,3000,557,421,3,418
ירושלים,3000,558,406,15,391
ירושלים,3000,559,496,38,458
ירושלים,3000,560,436,5,431
ירושלים,3000,561,379,6,373
ירושלים,3000,562,310,1,309
ירושלים,3000,563,425,4,421
ירושלים,3000,564,331,7,324
ירושלים,3000,565,332,2,330
ירושלים,3000,566,297,6,291
ירושלים,3000,567,542,0,542
ירושלים,3000,568,337,11,326
ירושלים,3000,569,417,5,412
ירושלים,3000,572,242,6,236
ירושלים,3000,573,432,25,407
ירושלים,3000,574,316,10,306
ירושלים,3000,575,444,12,432
ירושלים,3000,576,411,17,394
ירושלים,3000,577,520,15,505
ירושלים,3000,578,525,27,498
ירושלים,3000,579,470,0,470
ירושלים,3000,587,366,1,365
ירושלים,3000,588,486,24,462
ירושלים,3000,589,456,18,438
ירושלים,3000,590,444,3,441
ירושלים,3000,591,431,4,427
ירושלים,3000,592,381,2,379
ירושלים,3000,593,415,4,411
ירושלים,3000,594,418,9,409
ירושלים,3000,595,333,3,330
ירושלים,3000,596,411,1,410
ירושלים,3000,597,251,5,246
ירושלים,3000,598,409,4,405
ירושלים,3000,599,496,38,458
ירושלים,3000,600,507,4,503
ירושלים,3000,603,91,1,90
ירושלים,3000,604,91,0,91
ירושלים,3000,608,58,1,57
ירושלים,3000,609,43,0,43
ירושלים,3000,613,488,2,486
ירושלים,3000,614,47,0,47
ירושלים,3000,615,22,1,21
ירושלים,3000,618,70,0,70
ירושלים,3000,623,234,0,234
ירושלים,3000,631,212,3,209
ירושלים,3000,634,383,2,381
ירושלים,3000,635,339,2,337
ירושלים,3000,637,328,6,322
ירושלים,3000,638,332,2,330
ירושלים,3000,639,323,0,323
ירושלים,3000,640,400,2,398
ירושלים,3000,641,424,1,423
ירושלים,3000,642,391,5,386
ירושלים,3000,643,288,6,282
ירושלים,3000,644,433,1,432
ירושלים,3000,647,72,2,70
ירושלים,3000,649,116,1,115
ירושלים,3000,650,324,14,310
ירושלים,3000,651,411,12,399
ירושלים,3000,652,46,0,46
ירושלים,3000,658,370,2,368
ירושלים,3000,658,220,17,203
ירושלים,3000,659,554,10,544
ירושלים,3000,660,557,8,549
ירושלים,3000,668,102,3,99
ירושלים,3000,669,502,3,499
ירושלים,3000,671,497,2,495
ירושלים,3000,672,514,23,491
ירושלים,3000,673,462,5,457
ירושלים,3000,674,318,3,315
ירושלים,3000,675,523,16,507
ירושלים,3000,676,443,2,441
ירושלים,3000,677,426,2,424
ירושלים,3000,678,471,4,467
ירושלים,3000,679,384,5,379
ירושלים,3000,680,457,4,453
ירושלים,3000,681,397,3,394
ירושלים,3000,682,454,4,450
ירושלים,3000,683,411,6,405
ירושלים,3000,684,443,6,437
ירושלים,3000,685,473,7,466
ירושלים,3000,686,548,1,547
ירושלים,3000,687,514,10,504
ירושלים,3000,688,433,7,426
ירושלים,3000,689,543,1,542
ירושלים,3000,690,49,0,49
ירושלים,3000,691,401,4,397
ירושלים,3000,692,485,3,482
ירושלים,3000,693,563,3,560
ירושלים,3000,694,537,8,529
ירושלים,3000,697,485,20,465
ירושלים,3000,698,294,9,285
ירושלים,3000,699,432,11,421
ירושלים,3000,700,481,20,461
ירושלים,3000,701,414,10,404
ירושלים,3000,702,288,13,275
ירושלים,3000,703,535,18,517
ירושלים,3000,704,350,11,339
ירושלים,3000,705,545,14,531
ירושלים,3000,706,499,3,496
ירושלים,3000,707,490,17,473
ירושלים,3000,708,408,6,402
ירושלים,3000,709,323,0,323
ירושלים,3000,710,487,17,470
ירושלים,3000,711,594,24,570
ירושלים,3000,712,476,6,470
ירושלים,3000,713,349,17,332
ירושלים,3000,714,374,9,365
ירושלים,3000,715,419,3,416
ירושלים,3000,716,282,0,282
ירושלים,3000,717,402,4,398
ירושלים,3000,718,233,2,231
ירושלים,3000,719,566,20,546
ירושלים,3000,720,467,4,463
ירושלים,3000,721,478,6,472
ירושלים,3000,722,407,7,400
ירושלים,3000,723,490,2,488
ירושלים,3000,724,472,5,467
ירושלים,3000,725,460,3,457
ירושלים,3000,726,482,6,476
ירושלים,3000,727,481,1,480
ירושלים,3000,728,397,7,390
ירושלים,3000,729,449,5,444
ירושלים,3000,730,467,4,463
ירושלים,3000,731,466,4,462
ירושלים,3000,732,365,2,363
ירושלים,3000,733,477,5,472
ירושלים,3000,734,537,0,537
ירושלים,3000,735,497,4,493
ירושלים,3000,736,497,3,494
ירושלים,3000,737,428,2,426
ירושלים,3000,738,499,3,496
ירושלים,3000,739,508,5,503
ירושלים,3000,740,442,2,440
ירושלים,3000,742,49,0,49
ירושלים,3000,743,483,0,483
ירושלים,3000,744,475,3,472
ירושלים,3000,745,405,5,400
ירושלים,3000,746,331,6,325
ירושלים,3000,747,537,8,529
ירושלים,3000,748,539,7,532
ירושלים,3000,749,532,7,525
ירושלים,3000,750,551,8,543
ירושלים,3000,751,474,2,472
ירושלים,3000,752,364,5,359
ירושלים,3000,753,560,4,556
ירושלים,3000,754,492,1,491
ירושלים,3000,755,440,3,437
ירושלים,3000,756,407,2,405
ירושלים,3000,757,462,5,457
ירושלים,3000,758,395,7,388
ירושלים,3000,759,422,1,421
ירושלים,3000,760,355,19,336
ירושלים,3000,761,353,6,347
ירושלים,3000,762,424,5,419
ירושלים,3000,763,440,3,437
ירושלים,3000,764,459,0,459
ירושלים,3000,765,319,5,314
ירושלים,3000,766,412,5,407
ירושלים,3000,767,286,0,286
ירושלים,3000,768,561,2,559
ירושלים,3000,769,464,14,450
ירושלים,3000,770,333,2,331
ירושלים,3000,771,530,34,496
ירושלים,3000,772,631,26,605
ירושלים,3000,773,580,7,573
ירושלים,3000,774,400,3,397
ירושלים,3000,775,385,18,367
ירושלים,3000,775,253,13,240
ירושלים,3000,776,556,2,554
ירושלים,3000,777,521,18,503
ירושלים,3000,778,426,10,416
ירושלים,3000,779,606,25,581
ירושלים,3000,780,498,7,491
ירושלים,3000,781,561,4,557
ירושלים,3000,782,475,3,472
ירושלים,3000,783,517,20,497
ירושלים,3000,784,548,23,525
ירושלים,3000,785,410,11,399
ירושלים,3000,786,434,18,416
ירושלים,3000,787,510,3,507
ירושלים,3000,788,522,3,519
ירושלים,3000,789,478,2,476
ירושלים,3000,790,599,0,599
ירושלים,3000,791,450,9,441
ירושלים,3000,792,390,14,376
ירושלים,3000,793,503,5,498
ירושלים,3000,794,576,0,576
ירושלים,3000,795,378,3,375
ירושלים,3000,796,620,4,616
ירושלים,3000,797,355,2,353
ירושלים,3000,800,488,5,483
ירושלים,3000,801,639,18,621
ירושלים,3000,802,609,17,592
ירושלים,3000,803,333,4,329
ירושלים,3000,804,600,21,579
ירושלים,3000,805,419,12,407
ירושלים,3000,806,626,10,616
ירושלים,3000,807,417,10,407
ירושלים,3000,808,418,7,411
ירושלים,3000,809,616,24,592
ירושלים,3000,810,536,12,524
ירושלים,3000,811,584,15,569
ירושלים,3000,812,624,15,609
ירושלים,3000,813,237,1,236
ירושלים,3000,814,210,0,210
ירושלים,3000,815,336,0,336
ירושלים,3000,816,314,2,312
ירושלים,3000,817,375,4,371
ירושלים,3000,818,245,0,245
ירושלים,3000,819,393,5,388
ירושלים,3000,820,295,2,293
ירושלים,3000,821,312,5,307
ירושלים,3000,822,395,3,392
ירושלים,3000,823,465,4,461
ירושלים,3000,824,517,4,513
ירושלים,3000,825,288,3,285
ירושלים,3000,826,496,2,494
ירושלים,3000,830,371,0,371
ירושלים,3000,831,353,0,353
ירושלים,3000,849,459,13,446
ירושלים,3000,850,518,0,518
ירושלים,3000,851,533,3,530
ירושלים,3000,852,563,3,560
ירושלים,3000,853,592,2,590
ירושלים,3000,854,518,2,516
ירושלים,3000,855,345,0,345
ירושלים,3000,856,404,2,402
ירושלים,3000,857,474,15,459
ירושלים,3000,858,451,1,450
ירושלים,3000,859,602,2,600
ירושלים,3000,860,605,5,600
ירושלים,3000,861,385,10,375
ירושלים,3000,862,391,0,391
ירושלים,3000,863,417,1,416
ירושלים,3000,864,561,2,559
ירושלים,3000,870,549,4,545
ירושלים,3000,952,295,4,291
ירושלים,3000,958,384,5,379
ירושלים,3000,959,497,1,496
ירושלים,3000,960,605,5,600
ירושלים,3000,964,470,2,468
ירושלים,3000,965,358,3,355
ירושלים,3000,966,51,1,50
ירושלים,3000,967,346,2,344
ירושלים,3000,968,335,6,329
ירושלים,3000,969,298,1,297
ירושלים,3000,970,308,1,307
ירושלים,3000,972,293,1,292
ירושלים,3000,973,386,4,382
ירושלים,3000,974,495,14,481
ירושלים,3000,991,55,1,54
ירושלים,3000,994,41,0,41
ירושלים,3000,996,55,0,55
ירושלים,3000,997,59,0,59
ירחיב,718,1,510,7,503
ירכא,502,1,392,5,387
ירכא,502,2,406,18,388
ירכא,502,3,441,3,438
ירכא,502,4,405,5,400
ירכא,502,5,396,12,384
ירכא,502,6,477,9,468
ירכא,502,7,402,12,390
ירכא,502,8,435,7,428
ירכא,502,9,511,7,504
ירכא,502,10,402,17,385
ירכא,502,11,381,10,371
ירכא,502,12,489,10,479
ירכא,502,13,516,9,507
ירכא,502,14,515,19,496
ירקונה,183,1,235,1,234
ישע,916,1,189,1,188
ישעי,805,1,400,1,399
ישרש,828,1,514,6,508
יתד,1227,1,178,0,178
כאבול,504,1,601,2,599
כאבול,504,2,586,0,586
כאבול,504,3,598,6,592
כאבול,504,4,587,2,585
כאבול,504,5,623,3,620
כאבול,504,6,561,2,559
כאבול,504,7,556,4,552
כאבול,504,8,492,2,490
כאבול,504,9,575,2,573
כאבול,504,10,584,4,580
כאוכב אבו אל-היג',505,1,405,2,403
כאוכב אבו אל-היג',505,2,488,3,485
כאוכב אבו אל-היג',505,3,447,3,444
כאוכב אבו אל-היג',505,4,428,2,426
כברי,576,1,315,1,314
כברי,576,2,295,0,295
כדיתה,1338,1,65,0,65
כוכב השחר,3564,1,454,0,454
כוכב השחר,3564,2,418,1,417
כוכב יאיר,1224,1,573,1,572
כוכב יאיר,1224,2,378,4,374
כוכב יאיר,1224,3,379,0,379
כוכב יאיר,1224,4,427,0,427
כוכב יאיר,1224,5,397,1,396
כוכב יאיר,1224,6,335,0,335
כוכב יאיר,1224,7,366,0,366
כוכב יאיר,1224,101,496,1,495
כוכב יאיר,1224,102,431,0,431
כוכב יאיר,1224,103,615,0,615
כוכב יאיר,1224,104,433,2,431
כוכב יאיר,1224,105,498,1,497
כוכב יאיר,1224,106,384,1,383
כוכב יאיר,1224,107,380,6,374
כוכב יעקב,3779,1,545,3,542
כוכב יעקב,3779,2,525,3,522
כוכב יעקב,3779,3,606,3,603
כוכב יעקב,3779,4,525,5,520
כוכב יעקב,3779,5,499,2,497
כוכב מיכאל,824,1,493,0,493
כורזים,1252,1,233,0,233
כחל,1210,1,221,0,221
כיסופים,840,1,154,0,154
כישור,1153,1,84,0,84
כליל,1183,1,281,1,280
כלנית,1229,1,132,1,131
כמאנה,1331,1,275,4,271
כמאנה,1331,2,278,3,275
כמהין,1291,1,134,0,134
כמון,1201,1,389,3,386
כנף,4028,1,191,0,191
כנרת (מושבה),63,1,356,2,354
כנרת (קבוצה),57,1,439,1,438
כסיפה,1059,1,457,7,450
כסיפה,1059,2,279,0,279
כסיפה,1059,3,389,2,387
כסיפה,1059,4,253,10,243
כסיפה,1059,5,294,3,291
כסיפה,1059,6,308,9,299
כסיפה,1059,7,444,12,432
כסיפה,1059,8,278,9,269
כסיפה,1059,9,283,3,280
כסיפה,1059,10,264,1,263
כסלון,859,1,215,0,215
כסרא-סמיע,1296,1,396,6,390
כסרא-סמיע,1296,2,276,5,271
כסרא-סמיע,1296,3,296,0,296
כסרא-סמיע,1296,4,327,4,323
כסרא-סמיע,1296,5,459,5,454
כסרא-סמיע,1296,6,494,0,494
כסרא-סמיע,1296,7,382,4,378
כסרא-סמיע,1296,8,610,14,596
כעביה-טבאש-חג'אג',978,1,314,2,312
כעביה-טבאש-חג'אג',978,2,294,4,290
כעביה-טבאש-חג'אג',978,3,254,1,253
כעביה-טבאש-חג'אג',978,4,337,0,337
כעביה-טבאש-חג'אג',978,5,238,1,237
כפר אביב,857,1,420,4,416
כפר אדומים,3638,1,585,0,585
כפר אדומים,3638,2,557,0,557
כפר אדומים,3638,3,539,0,539
כפר אוריה,364,1,402,0,402
כפר אחים,690,1,386,2,384
כפר ביאליק,220,1,318,1,317
"כפר ביל""ו",177,1,484,3,481
"כפר ביל""ו",177,2,200,1,199
כפר בלום,357,1,452,1,451
כפר בן נון,2010,1,381,0,381
כפר ברא,633,1,514,3,511
כפר ברא,633,2,474,1,473
כפר ברא,633,3,469,5,464
כפר ברוך,132,1,257,1,256
כפר גדעון,106,1,130,0,130
כפר גלים,427,1,60,1,59
כפר גליקסון,310,1,194,2,192
כפר גלעדי,76,1,366,4,362
כפר דניאל,707,1,364,0,364
כפר האורנים,3796,1,554,4,550
כפר האורנים,3796,2,550,1,549
כפר החורש,192,1,334,3,331
כפר המכבי,254,1,200,0,200
כפר הנגיד,582,1,269,2,267
כפר הנגיד,582,2,323,0,323
כפר הנשיא,443,1,408,4,404
כפר הס,187,1,373,1,372
כפר הס,187,2,381,1,380
"כפר הרא""ה",217,1,306,1,305
"כפר הרא""ה",217,2,294,0,294
"כפר הרי""ף",888,1,454,4,450
כפר ויתקין,190,1,525,1,524
כפר ויתקין,190,2,562,4,558
כפר ורבורג,320,1,323,1,322
כפר ורבורג,320,2,275,0,275
כפר ורדים,1263,1,507,3,504
כפר ורדים,1263,2,322,2,320
כפר ורדים,1263,3,420,1,419
כפר ורדים,1263,4,576,2,574
כפר ורדים,1263,5,558,0,558
כפר ורדים,1263,6,579,0,579
כפר ורדים,1263,7,325,4,321
כפר זיתים,786,1,319,0,319
"כפר חב""ד",696,1,382,3,379
"כפר חב""ד",696,2,505,0,505
"כפר חב""ד",696,3,382,1,381
"כפר חב""ד",696,4,509,0,509
"כפר חב""ד",696,5,437,2,435
"כפר חב""ד",696,6,402,0,402
כפר חושן,609,1,396,3,393
כפר חיטים,255,1,356,1,355
כפר חיים,193,1,327,1,326
כפר חנניה,1297,1,333,1,332
כפר חסידים א',112,1,393,1,392
כפר חסידים ב',889,1,201,1,200
כפר חרוב,4004,1,216,1,215
כפר טרומן,673,1,445,2,443
כפר יאסיף,507,1,467,3,464
כפר יאסיף,507,2,388,3,385
כפר יאסיף,507,3,553,6,547
כפר יאסיף,507,4,384,2,382
כפר יאסיף,507,5,465,0,465
כפר יאסיף,507,6,561,9,552
כפר יאסיף,507,7,450,1,449
כפר יאסיף,507,8,455,1,454
כפר יאסיף,507,9,520,0,520
כפר יאסיף,507,10,420,3,417
כפר יאסיף,507,11,454,4,450
כפר ידידיה,233,1,399,1,398
כפר יהושע,140,1,587,2,585
כפר יונה,168,1,404,9,395
כפר יונה,168,2,542,6,536
כפר יונה,168,3,497,3,494
כפר יונה,168,4,337,6,331
כפר יונה,168,5,595,2,593
כפר יונה,168,6,533,2,531
כפר יונה,168,7,578,1,577
כפר יונה,168,8,498,4,494
כפר יונה,168,9,557,1,556
כפר יונה,168,10,435,5,430
כפר יונה,168,11,457,5,452
כפר יונה,168,12,463,2,461
כפר יונה,168,13,458,2,456
כפר יונה,168,14,488,7,481
כפר יונה,168,15,522,1,521
כפר יונה,168,16,390,4,386
כפר יונה,168,17,594,6,588
כפר יונה,168,18,489,1,488
כפר יונה,168,19,432,4,428
כפר יונה,168,20,487,6,481
כפר יונה,168,21,527,2,525
כפר יונה,168,22,283,4,279
כפר יחזקאל,85,1,555,5,550
כפר יעבץ,170,1,376,2,374
כפר כמא,508,1,294,13,281
כפר כמא,508,2,265,6,259
כפר כמא,508,3,275,3,272
כפר כמא,508,4,277,6,271
כפר כנא,509,1,519,4,515
כפר כנא,509,2,524,1,523
כפר כנא,509,3,469,2,467
כפר כנא,509,4,454,4,450
כפר כנא,509,5,423,5,418
כפר כנא,509,6,578,0,578
כפר כנא,509,7,551,3,548
כפר כנא,509,8,539,2,537
כפר כנא,509,9,507,4,503
כפר כנא,509,10,522,3,519
כפר כנא,509,11,465,3,462
כפר כנא,509,12,465,0,465
כפר כנא,509,13,498,6,492
כפר כנא,509,14,517,1,516
כפר כנא,509,15,455,3,452
כפר כנא,509,16,484,3,481
כפר כנא,509,17,453,3,450
כפר כנא,509,18,381,0,381
כפר מונש,387,1,253,0,253
כפר מונש,387,2,238,3,235
כפר מימון,1095,1,303,0,303
"כפר מל""ל",98,1,239,3,236
כפר מנדא,510,1,436,4,432
כפר מנדא,510,2,503,12,491
כפר מנדא,510,3,532,14,518
כפר מנדא,510,4,582,9,573
כפר מנדא,510,5,579,22,557
כפר מנדא,510,6,551,13,538
כפר מנדא,510,7,591,1,590
כפר מנדא,510,8,553,3,550
כפר מנדא,510,9,537,4,533
כפר מנדא,510,10,525,3,522
כפר מנדא,510,11,565,12,553
כפר מנדא,510,12,528,12,516
כפר מנדא,510,13,519,8,511
כפר מנדא,510,14,587,5,582
כפר מנדא,510,15,474,3,471
כפר מנחם,274,1,619,2,617
כפר מסריק,297,1,388,2,386
כפר מצר,512,1,354,10,344
כפר מצר,512,2,308,5,303
כפר מצר,512,3,279,10,269
כפר מרדכי,764,1,344,2,342
כפר נטר,316,1,561,0,561
כפר סאלד,345,1,333,0,333
כפר סבא,6900,1,499,7,492
כפר סבא,6900,2,475,3,472
כפר סבא,6900,3,485,4,481
כפר סבא,6900,4,435,7,428
כפר סבא,6900,5,303,4,299
כפר סבא,6900,6,381,4,377
כפר סבא,6900,7,562,7,555
כפר סבא,6900,8,306,3,303
כפר סבא,6900,9,480,8,472
כפר סבא,6900,10,440,2,438
כפר סבא,6900,11,431,3,428
כפר סבא,6900,12,534,2,532
כפר סבא,6900,13,384,3,381
כפר סבא,6900,14,376,1,375
כפר סבא,6900,15,439,2,437
כפר סבא,6900,16,648,1,647
כפר סבא,6900,17,526,3,523
כפר סבא,6900,18,435,1,434
כפר סבא,6900,19,404,1,403
כפר סבא,6900,20,617,2,615
כפר סבא,6900,21,544,1,543
כפר סבא,6900,22,452,3,449
כפר סבא,6900,23,326,3,323
כפר סבא,6900,24,494,9,485
כפר סבא,6900,25,450,5,445
כפר סבא,6900,26,409,3,406
כפר סבא,6900,27,467,8,459
כפר סבא,6900,28,455,1,454
כפר סבא,6900,29,400,2,398
כפר סבא,6900,30,507,6,501
כפר סבא,6900,31,447,8,439
כפר סבא,6900,32,521,0,521
כפר סבא,6900,33,488,5,483
כפר סבא,6900,34,338,1,337
כפר סבא,6900,35,345,4,341
כפר סבא,6900,36,378,2,376
כפר סבא,6900,37,430,3,427
כפר סבא,6900,38,433,2,431
כפר סבא,6900,39,517,6,511
כפר סבא,6900,40,445,3,442
כפר סבא,6900,41,430,3,427
כפר סבא,6900,42,298,7,291
כפר סבא,6900,43,392,2,390
כפר סבא,6900,44,538,3,535
כפר סבא,6900,45,472,3,469
כפר סבא,6900,46,419,2,417
כפר סבא,6900,47,426,6,420
כפר סבא,6900,48,448,0,448
כפר סבא,6900,49,285,0,285
כפר סבא,6900,50,438,1,437
כפר סבא,6900,51,531,6,525
כפר סבא,6900,52,494,7,487
כפר סבא,6900,53,434,0,434
כפר סבא,6900,54,539,5,534
כפר סבא,6900,55,481,8,473
כפר סבא,6900,56,491,2,489
כפר סבא,6900,57,530,5,525
כפר סבא,6900,58,496,3,493
כפר סבא,6900,59,442,4,438
כפר סבא,6900,60,460,0,460
כפר סבא,6900,61,355,3,352
כפר סבא,6900,62,492,7,485
כפר סבא,6900,63,447,3,444
כפר סבא,6900,64,501,4,497
כפר סבא,6900,65,472,10,462
כפר סבא,6900,66,437,3,434
כפר סבא,6900,67,514,6,508
כפר סבא,6900,68,534,3,531
כפר סבא,6900,69,386,1,385
כפר סבא,6900,70,506,2,504
כפר סבא,6900,71,303,6,297
כפר סבא,6900,72,402,10,392
כפר סבא,6900,73,390,2,388
כפר סבא,6900,74,489,5,484
כפר סבא,6900,75,483,3,480
כפר סבא,6900,76,478,2,476
כפר סבא,6900,77,261,5,256
כפר סבא,6900,78,351,2,349
כפר סבא,6900,79,425,4,421
כפר סבא,6900,80,541,5,536
כפר סבא,6900,81,445,5,440
כפר סבא,6900,82,310,1,309
כפר סבא,6900,83,202,0,202
כפר סבא,6900,84,400,4,396
כפר סבא,6900,85,498,3,495
כפר סבא,6900,86,310,1,309
כפר סבא,6900,87,438,3,435
כפר סבא,6900,88,547,3,544
כפר סבא,6900,89,413,0,413
כפר סבא,6900,90,425,3,422
כפר סבא,6900,91,458,4,454
כפר סבא,6900,92,509,3,506
כפר סבא,6900,93,325,3,322
כפר סבא,6900,94,523,5,518
כפר סבא,6900,95,463,3,460
כפר סבא,6900,96,557,8,549
כפר סבא,6900,97,423,4,419
כפר סבא,6900,98,392,5,387
כפר סבא,6900,99,600,1,599
כפר סבא,6900,100,383,11,372
כפר סבא,6900,101,481,2,479
כפר סבא,6900,102,359,4,355
כפר סבא,6900,103,505,2,503
כפר סבא,6900,104,387,3,384
כפר סבא,6900,105,286,1,285
כפר סבא,6900,106,272,2,270
כפר סבא,6900,107,345,4,341
כפר סבא,6900,108,248,10,238
כפר סבא,6900,109,208,1,207
כפר סבא,6900,110,468,4,464
כפר סבא,6900,111,417,2,415
כפר סבא,6900,112,642,5,637
כפר סבא,6900,113,456,0,456
כפר סבא,6900,114,525,0,525
כפר סבא,6900,115,412,6,406
כפר סבא,6900,116,292,2,290
כפר סבא,6900,117,507,3,504
כפר סבא,6900,118,422,2,420
כפר סבא,6900,119,520,0,520
כפר סבא,6900,120,503,3,500
כפר סבא,6900,121,509,6,503
כפר סבא,6900,122,654,5,649
כפר סבא,6900,123,466,7,459
כפר סבא,6900,124,568,3,565
כפר סבא,6900,125,499,0,499
כפר סבא,6900,126,469,3,466
כפר סבא,6900,127,589,5,584
כפר סבא,6900,951,482,1,481
כפר סילבר,107,1,51,0,51
כפר סירקין,249,1,299,0,299
כפר סירקין,249,2,375,3,372
כפר עזה,845,1,509,0,509
כפר עציון,3488,1,337,0,337
כפר פינס,189,1,298,1,297
כפר קאסם,634,1,314,4,310
כפר קאסם,634,2,472,1,471
כפר קאסם,634,3,549,4,545
כפר קאסם,634,4,436,0,436
כפר קאסם,634,5,488,2,486
כפר קאסם,634,6,502,5,497
כפר קאסם,634,7,577,6,571
כפר קאסם,634,8,0,0,0
כפר קאסם,634,9,523,4,519
כפר קאסם,634,10,504,3,501
כפר קאסם,634,11,0,0,0
כפר קאסם,634,12,305,0,305
כפר קאסם,634,13,499,0,499
כפר קאסם,634,14,429,0,429
כפר קאסם,634,15,469,4,465
כפר קאסם,634,16,470,1,469
כפר קאסם,634,17,322,2,320
כפר קאסם,634,18,467,1,466
כפר קאסם,634,19,434,1,433
כפר קאסם,634,20,296,6,290
כפר קיש,388,1,278,2,276
כפר קרע,654,1,515,2,513
כפר קרע,654,2,539,4,535
כפר קרע,654,3,552,9,543
כפר קרע,654,4,577,2,575
כפר קרע,654,5,541,0,541
כפר קרע,654,6,526,1,525
כפר קרע,654,7,497,4,493
כפר קרע,654,8,467,7,460
כפר קרע,654,9,548,4,544
כפר קרע,654,10,557,7,550
כפר קרע,654,11,518,5,513
כפר קרע,654,12,459,1,458
כפר קרע,654,13,545,1,544
כפר קרע,654,14,498,2,496
כפר קרע,654,15,526,8,518
כפר קרע,654,16,514,2,512
כפר ראש הנקרה,579,1,342,0,342
כפר ראש הנקרה,579,2,326,2,324
כפר רוזנואלד (זרע,1130,1,148,0,148
כפר רופין,295,1,268,0,268
כפר רות,1166,1,156,0,156
כפר שמאי,605,1,224,0,224
כפר שמואל,743,1,437,5,432
כפר שמריהו,267,1,359,5,354
כפר שמריהו,267,2,421,2,419
כפר שמריהו,267,3,427,2,425
כפר תבור,47,1,523,0,523
כפר תבור,47,2,456,0,456
כפר תבור,47,3,565,0,565
כפר תבור,47,4,553,3,550
כפר תפוח,3572,1,372,1,371
כרכום,1285,1,337,2,335
כרם בן זמרה,664,1,288,0,288
כרם יבנה (ישיבה),1094,1,147,0,147
"כרם מהר""ל",580,1,478,0,478
כרם שלום,1085,1,48,0,48
כרמי יוסף,1264,1,389,3,386
כרמי יוסף,1264,2,383,3,380
כרמי יוסף,1264,3,357,1,356
כרמי צור,3766,1,475,0,475
כרמיאל,1139,1,252,5,247
כרמיאל,1139,2,262,4,258
כרמיאל,1139,3,407,13,394
כרמיאל,1139,4,287,8,279
כרמיאל,1139,5,248,4,244
כרמיאל,1139,6,318,8,310
כרמיאל,1139,7,277,8,269
כרמיאל,1139,8,290,8,282
כרמיאל,1139,9,410,2,408
כרמיאל,1139,10,346,12,334
כרמיאל,1139,11,348,2,346
כרמיאל,1139,12,167,5,162
כרמיאל,1139,13,263,12,251
כרמיאל,1139,14,588,2,586
כרמיאל,1139,15,275,6,269
כרמיאל,1139,16,299,5,294
כרמיאל,1139,17,409,2,407
כרמיאל,1139,18,283,10,273
כרמיאל,1139,19,297,12,285
כרמיאל,1139,20,389,11,378
כרמיאל,1139,21,412,3,409
כרמיאל,1139,22,257,12,245
כרמיאל,1139,23,381,14,367
כרמיאל,1139,24,174,1,173
כרמיאל,1139,25,338,7,331
כרמיאל,1139,26,321,6,315
כרמיאל,1139,27,335,3,332
כרמיאל,1139,28,386,3,383
כרמיאל,1139,29,411,3,408
כרמיאל,1139,30,361,5,356
כרמיאל,1139,31,311,4,307
כרמיאל,1139,32,313,8,305
כרמיאל,1139,33,207,4,203
כרמיאל,1139,34,388,3,385
כרמיאל,1139,35,466,5,461
כרמיאל,1139,36,382,6,376
כרמיאל,1139,37,320,2,318
כרמיאל,1139,38,349,9,340
כרמיאל,1139,39,436,5,431
כרמיאל,1139,40,334,8,326
כרמיאל,1139,41,380,5,375
כרמיאל,1139,42,470,6,464
כרמיאל,1139,43,614,6,608
כרמיאל,1139,44,352,10,342
כרמיאל,1139,45,312,8,304
כרמיאל,1139,46,399,6,393
כרמיאל,1139,47,355,0,355
כרמיאל,1139,48,360,6,354
כרמיאל,1139,49,353,11,342
כרמיאל,1139,50,331,1,330
כרמיאל,1139,51,385,3,382
כרמיאל,1139,52,370,7,363
כרמיאל,1139,53,534,6,528
כרמיאל,1139,54,528,3,525
כרמיאל,1139,55,490,18,472
כרמיאל,1139,56,452,5,447
כרמיאל,1139,57,378,5,373
כרמיאל,1139,58,589,6,583
כרמיאל,1139,59,420,13,407
כרמיאל,1139,60,338,10,328
כרמיאל,1139,61,275,5,270
כרמיאל,1139,62,536,6,530
כרמיאל,1139,63,456,9,447
כרמיאל,1139,64,389,6,383
כרמיאל,1139,65,389,1,388
כרמיאל,1139,66,280,7,273
כרמיאל,1139,67,329,3,326
כרמיאל,1139,68,491,12,479
כרמיאל,1139,69,310,1,309
כרמיה,768,1,356,0,356
כרמים,1198,1,95,0,95
כרמל,3656,1,214,0,214
לבון,1207,1,283,2,281
לביא,585,1,386,0,386
לבנים,1230,1,222,0,222
להב,2023,1,289,0,289
להבות הבשן,380,1,463,2,461
להבות חביבה,715,1,383,1,382
להבים,1271,1,537,0,537
להבים,1271,2,492,1,491
להבים,1271,3,367,1,366
להבים,1271,4,478,0,478
להבים,1271,5,376,0,376
להבים,1271,6,543,1,542
להבים,1271,7,460,2,458
להבים,1271,8,456,0,456
לוד,7000,2,223,2,221
לוד,7000,3,248,5,243
לוד,7000,4,154,4,150
לוד,7000,5,304,3,301
לוד,7000,6,358,11,347
לוד,7000,7,315,5,310
לוד,7000,8,303,3,300
לוד,7000,9,518,2,516
לוד,7000,10,449,10,439
לוד,7000,11,308,9,299
לוד,7000,12,330,5,325
לוד,7000,13,375,5,370
לוד,7000,14,223,1,222
לוד,7000,15,408,4,404
לוד,7000,16,511,7,504
לוד,7000,17,396,3,393
לוד,7000,18,323,10,313
לוד,7000,19,340,11,329
לוד,7000,20,363,8,355
לוד,7000,21,381,12,369
לוד,7000,22,323,12,311
לוד,7000,23,335,5,330
לוד,7000,24,311,4,307
לוד,7000,25,423,4,419
לוד,7000,26,352,10,342
לוד,7000,27,415,4,411
לוד,7000,28,290,2,288
לוד,7000,29,401,3,398
לוד,7000,30,499,5,494
לוד,7000,31,432,4,428
לוד,7000,32,391,3,388
לוד,7000,33,360,8,352
לוד,7000,34,353,18,335
לוד,7000,35,256,0,256
לוד,7000,36,234,5,229
לוד,7000,37,426,6,420
לוד,7000,38,360,7,353
לוד,7000,39,231,5,226
לוד,7000,40,288,9,279
לוד,7000,41,333,7,326
לוד,7000,42,298,5,293
לוד,7000,43,376,11,365
לוד,7000,44,223,1,222
לוד,7000,45,331,2,329
לוד,7000,46,275,7,268
לוד,7000,47,333,5,328
לוד,7000,48,412,5,407
לוד,7000,49,456,4,452
לוד,7000,50,408,1,407
לוד,7000,51,307,5,302
לוד,7000,52,400,0,400
לוד,7000,53,457,0,457
לוד,7000,54,399,4,395
לוד,7000,55,386,5,381
לוד,7000,56,327,2,325
לוד,7000,57,507,11,496
לוד,7000,58,463,8,455
לוד,7000,59,305,0,305
לוד,7000,60,345,3,342
לוד,7000,61,486,2,484
לוד,7000,62,395,6,389
לוד,7000,63,262,3,259
לוד,7000,64,397,3,394
לוד,7000,65,284,3,281
לוד,7000,66,243,7,236
לוד,7000,67,300,7,293
לוד,7000,68,313,7,306
לוד,7000,69,297,13,284
לוד,7000,70,442,9,433
לוד,7000,71,333,3,330
לוד,7000,72,363,9,354
לוד,7000,73,432,5,427
לוד,7000,74,313,5,308
לוד,7000,75,429,4,425
לוד,7000,76,410,7,403
לוד,7000,77,499,16,483
לוד,7000,78,335,2,333
לוד,7000,79,346,8,338
לוד,7000,80,442,26,416
לוד,7000,81,242,3,239
לוד,7000,82,296,5,291
לוד,7000,83,531,13,518
לוד,7000,84,319,8,311
לוד,7000,85,307,7,300
לוד,7000,86,385,4,381
לוד,7000,87,416,2,414
לוד,7000,88,306,8,298
לוד,7000,90,366,8,358
לוד,7000,91,224,3,221
לוד,7000,952,560,16,544
לוד,7000,953,337,3,334
לוזית,52,1,276,0,276
לוחמי הגיטאות,595,1,347,2,345
לוטם,1171,1,318,2,316
לוטן,1255,1,85,2,83
לימן,674,1,391,1,390
לכיש,24,1,408,3,405
לפיד,1310,1,413,2,411
לפיד,1310,2,416,0,416
לפיד,1310,3,491,7,484
לפידות,1173,1,93,0,93
לקיה,1060,1,436,7,429
לקיה,1060,2,300,3,297
לקיה,1060,3,231,4,227
לקיה,1060,4,244,10,234
לקיה,1060,5,283,3,280
לקיה,1060,6,453,2,451
לקיה,1060,7,245,4,241
לקיה,1060,8,267,6,261
לקיה,1060,9,237,7,230
מאור,2055,1,612,1,611
מאיר שפיה,102,1,49,0,49
מבוא ביתר,771,1,383,4,379
מבוא דותן,3569,1,169,0,169
מבוא חורון,3709,1,438,2,436
מבוא חורון,3709,2,423,1,422
מבוא חמה,4204,1,242,1,241
מבוא מודיעים,1141,1,122,0,122
מבועים,1080,1,340,0,340
מבועים,1080,2,271,1,270
מבטחים,829,1,230,2,228
מבקיעים,573,1,233,2,231
מבשרת ציון,1015,1,519,9,510
מבשרת ציון,1015,2,519,1,518
מבשרת ציון,1015,3,411,0,411
מבשרת ציון,1015,4,362,5,357
מבשרת ציון,1015,5,509,2,507
מבשרת ציון,1015,6,539,5,534
מבשרת ציון,1015,7,376,3,373
מבשרת ציון,1015,8,309,2,307
מבשרת ציון,1015,8,240,2,238
מבשרת ציון,1015,9,425,3,422
מבשרת ציון,1015,10,477,0,477
מבשרת ציון,1015,11,502,2,500
מבשרת ציון,1015,12,434,0,434
מבשרת ציון,1015,13,379,2,377
מבשרת ציון,1015,14,531,2,529
מבשרת ציון,1015,15,321,4,317
מבשרת ציון,1015,16,454,2,452
מבשרת ציון,1015,17,488,1,487
מבשרת ציון,1015,18,315,0,315
מבשרת ציון,1015,19,473,0,473
מבשרת ציון,1015,20,489,2,487
מבשרת ציון,1015,21,429,0,429
מבשרת ציון,1015,22,491,2,489
מבשרת ציון,1015,23,438,1,437
מבשרת ציון,1015,24,478,2,476
מבשרת ציון,1015,25,468,1,467
מבשרת ציון,1015,26,496,2,494
מבשרת ציון,1015,27,529,3,526
מבשרת ציון,1015,28,400,5,395
מבשרת ציון,1015,30,446,2,444
מבשרת ציון,1015,33,329,3,326
מבשרת ציון,1015,34,442,4,438
מג'ד אל-כרום,516,1,581,0,581
מג'ד אל-כרום,516,2,621,6,615
מג'ד אל-כרום,516,3,515,2,513
מג'ד אל-כרום,516,4,529,3,526
מג'ד אל-כרום,516,5,446,1,445
מג'ד אל-כרום,516,6,438,3,435
מג'ד אל-כרום,516,7,551,1,550
מג'ד אל-כרום,516,8,502,4,498
מג'ד אל-כרום,516,9,513,3,510
מג'ד אל-כרום,516,10,565,2,563
מג'ד אל-כרום,516,11,488,0,488
מג'ד אל-כרום,516,12,486,5,481
מג'ד אל-כרום,516,13,456,3,453
מג'דל שמס,4201,1,114,7,107
מגאר,481,1,358,3,355
מגאר,481,2,306,4,302
מגאר,481,3,367,4,363
מגאר,481,4,278,4,274
מגאר,481,5,296,5,291
מגאר,481,6,291,10,281
מגאר,481,7,308,6,302
מגאר,481,8,374,5,369
מגאר,481,9,299,5,294
מגאר,481,10,315,6,309
מגאר,481,11,322,5,317
מגאר,481,12,344,7,337
מגאר,481,13,328,5,323
מגאר,481,14,327,6,321
מגאר,481,15,300,3,297
מגאר,481,16,397,10,387
מגאר,481,17,320,6,314
מגאר,481,18,327,8,319
מגאר,481,19,292,3,289
מגאר,481,20,275,4,271
מגאר,481,21,263,7,256
מגדים,689,1,616,7,609
מגדל העמק,874,1,400,4,396
מגדל העמק,874,2,364,5,359
מגדל העמק,874,3,258,1,257
מגדל העמק,874,4,442,2,440
מגדל העמק,874,5,282,12,270
מגדל העמק,874,6,300,3,297
מגדל העמק,874,7,463,6,457
מגדל העמק,874,8,464,11,453
מגדל העמק,874,9,267,7,260
מגדל העמק,874,10,298,11,287
מגדל העמק,874,11,377,8,369
מגדל העמק,874,12,311,10,301
מגדל העמק,874,13,358,6,352
מגדל העמק,874,14,460,10,450
מגדל העמק,874,15,254,5,249
מגדל העמק,874,16,462,6,456
מגדל העמק,874,17,271,1,270
מגדל העמק,874,18,363,3,360
מגדל העמק,874,21,366,4,362
מגדל העמק,874,22,416,6,410
מגדל העמק,874,23,295,4,291
מגדל העמק,874,29,372,2,370
מגדל העמק,874,30,507,9,498
מגדל העמק,874,31,422,3,419
מגדל העמק,874,32,423,4,419
מגדל העמק,874,33,440,8,432
מגדל העמק,874,34,354,7,347
מגדל העמק,874,35,434,5,429
מגדל העמק,874,36,298,6,292
מגדל העמק,874,37,371,1,370
מגדל העמק,874,38,482,8,474
מגדל העמק,874,40,524,2,522
מגדל העמק,874,41,274,9,265
מגדל העמק,874,42,597,2,595
מגדל העמק,874,43,527,8,519
מגדל עוז,3561,1,173,0,173
מגדל,65,1,395,1,394
מגדל,65,2,463,1,462
מגדלים,3751,1,93,0,93
מגידו,586,1,448,0,448
מגל,375,1,600,3,597
מגן שאול,1155,1,260,2,258
מגן,695,1,340,3,337
מגשימים,722,1,482,0,482
מדרך עוז,2029,1,396,5,391
מדרשת בן גוריון,1140,1,409,2,407
מדרשת בן גוריון,1140,2,327,1,326
מודיעין עילית,3797,1,599,5,594
מודיעין עילית,3797,2,499,17,482
מודיעין עילית,3797,3,689,56,633
מודיעין עילית,3797,4,545,29,516
מודיעין עילית,3797,5,549,25,524
מודיעין עילית,3797,6,624,53,571
מודיעין עילית,3797,7,661,46,615
מודיעין עילית,3797,8,524,22,502
מודיעין עילית,3797,9,661,51,610
מודיעין עילית,3797,10,365,28,337
מודיעין עילית,3797,11,580,15,565
מודיעין עילית,3797,12,480,54,426
מודיעין עילית,3797,13,559,39,520
מודיעין עילית,3797,14,596,42,554
מודיעין עילית,3797,15,561,23,538
מודיעין עילית,3797,16,522,26,496
מודיעין עילית,3797,17,552,21,531
מודיעין עילית,3797,18,580,20,560
מודיעין עילית,3797,19,651,36,615
מודיעין עילית,3797,20,509,31,478
מודיעין עילית,3797,22,568,36,532
מודיעין עילית,3797,23,536,53,483
מודיעין עילית,3797,24,528,26,502
מודיעין עילית,3797,25,638,2,636
מודיעין עילית,3797,26,415,27,388
מודיעין עילית,3797,27,539,26,513
מודיעין עילית,3797,28,592,35,557
מודיעין עילית,3797,29,611,25,586
מודיעין עילית,3797,30,442,3,439
מודיעין עילית,3797,31,655,57,598
מודיעין עילית,3797,32,617,23,594
מודיעין עילית,3797,33,631,41,590
מודיעין עילית,3797,34,579,42,537
מודיעין עילית,3797,36,686,23,663
מודיעין עילית,3797,37,414,8,406
מודיעין עילית,3797,38,400,22,378
מודיעין עילית,3797,38,369,19,350
מודיעין עילית,3797,39,476,29,447
מודיעין-מכבים-רעו,1200,1,556,5,551
מודיעין-מכבים-רעו,1200,2,541,3,538
מודיעין-מכבים-רעו,1200,3,548,3,545
מודיעין-מכבים-רעו,1200,4,534,1,533
מודיעין-מכבים-רעו,1200,5,448,4,444
מודיעין-מכבים-רעו,1200,6,620,7,613
מודיעין-מכבים-רעו,1200,7,386,2,384
מודיעין-מכבים-רעו,1200,8,534,1,533
מודיעין-מכבים-רעו,1200,9,533,1,532
מודיעין-מכבים-רעו,1200,10,540,1,539
מודיעין-מכבים-רעו,1200,11,539,2,537
מודיעין-מכבים-רעו,1200,12,530,6,524
מודיעין-מכבים-רעו,1200,13,538,3,535
מודיעין-מכבים-רעו,1200,14,525,1,524
מודיעין-מכבים-רעו,1200,15,498,2,496
מודיעין-מכבים-רעו,1200,16,571,1,570
מודיעין-מכבים-רעו,1200,17,485,2,483
מודיעין-מכבים-רעו,1200,18,596,3,593
מודיעין-מכבים-רעו,1200,19,533,3,530
מודיעין-מכבים-רעו,1200,20,556,1,555
מודיעין-מכבים-רעו,1200,21,394,1,393
מודיעין-מכבים-רעו,1200,22,546,2,544
מודיעין-מכבים-רעו,1200,23,599,1,598
מודיעין-מכבים-רעו,1200,24,539,1,538
מודיעין-מכבים-רעו,1200,25,525,2,523
מודיעין-מכבים-רעו,1200,26,572,5,567
מודיעין-מכבים-רעו,1200,27,465,2,463
מודיעין-מכבים-רעו,1200,28,401,1,400
מודיעין-מכבים-רעו,1200,29,389,0,389
מודיעין-מכבים-רעו,1200,30,376,6,370
מודיעין-מכבים-רעו,1200,31,520,1,519
מודיעין-מכבים-רעו,1200,32,508,2,506
מודיעין-מכבים-רעו,1200,33,414,0,414
מודיעין-מכבים-רעו,1200,34,418,0,418
מודיעין-מכבים-רעו,1200,35,618,4,614
מודיעין-מכבים-רעו,1200,36,564,0,564
מודיעין-מכבים-רעו,1200,37,608,3,605
מודיעין-מכבים-רעו,1200,38,567,5,562
מודיעין-מכבים-רעו,1200,39,463,0,463
מודיעין-מכבים-רעו,1200,40,524,1,523
מודיעין-מכבים-רעו,1200,41,555,0,555
מודיעין-מכבים-רעו,1200,42,565,2,563
מודיעין-מכבים-רעו,1200,43,564,0,564
מודיעין-מכבים-רעו,1200,44,616,0,616
מודיעין-מכבים-רעו,1200,45,429,0,429
מודיעין-מכבים-רעו,1200,46,543,6,537
מודיעין-מכבים-רעו,1200,47,390,0,390
מודיעין-מכבים-רעו,1200,48,599,2,597
מודיעין-מכבים-רעו,1200,49,474,3,471
מודיעין-מכבים-רעו,1200,50,616,2,614
מודיעין-מכבים-רעו,1200,51,485,2,483
מודיעין-מכבים-רעו,1200,52,398,2,396
מודיעין-מכבים-רעו,1200,53,437,0,437
מודיעין-מכבים-רעו,1200,54,572,4,568
מודיעין-מכבים-רעו,1200,55,629,2,627
מודיעין-מכבים-רעו,1200,56,371,2,369
מודיעין-מכבים-רעו,1200,57,441,2,439
מודיעין-מכבים-רעו,1200,58,516,3,513
מודיעין-מכבים-רעו,1200,59,345,0,345
מודיעין-מכבים-רעו,1200,60,585,2,583
מודיעין-מכבים-רעו,1200,61,487,2,485
מודיעין-מכבים-רעו,1200,62,603,1,602
מודיעין-מכבים-רעו,1200,63,467,5,462
מודיעין-מכבים-רעו,1200,64,511,2,509
מודיעין-מכבים-רעו,1200,65,557,2,555
מודיעין-מכבים-רעו,1200,66,548,1,547
מודיעין-מכבים-רעו,1200,67,547,0,547
מודיעין-מכבים-רעו,1200,68,439,1,438
מודיעין-מכבים-רעו,1200,69,666,0,666
מודיעין-מכבים-רעו,1200,73,545,4,541
מודיעין-מכבים-רעו,1200,74,519,2,517
מודיעין-מכבים-רעו,1200,75,404,1,403
מודיעין-מכבים-רעו,1200,77,418,1,417
מודיעין-מכבים-רעו,1200,78,441,4,437
מודיעין-מכבים-רעו,1200,101,403,0,403
מודיעין-מכבים-רעו,1200,102,562,1,561
מודיעין-מכבים-רעו,1200,103,472,1,471
מודיעין-מכבים-רעו,1200,104,364,0,364
מודיעין-מכבים-רעו,1200,105,445,1,444
מודיעין-מכבים-רעו,1200,106,525,1,524
מודיעין-מכבים-רעו,1200,107,391,2,389
מודיעין-מכבים-רעו,1200,108,553,1,552
מודיעין-מכבים-רעו,1200,109,504,1,503
מודיעין-מכבים-רעו,1200,110,358,1,357
מודיעין-מכבים-רעו,1200,111,389,2,387
מודיעין-מכבים-רעו,1200,112,397,2,395
מודיעין-מכבים-רעו,1200,113,355,0,355
מודיעין-מכבים-רעו,1200,114,374,3,371
מולדה,1360,1,59,0,59
מולדת,269,1,259,0,259
מולדת,269,2,292,3,289
מוצא עילית,208,1,230,2,228
מוצא עילית,208,2,277,2,275
מוקייבלה,635,1,452,1,451
מוקייבלה,635,2,444,7,437
מוקייבלה,635,3,443,3,440
מורן,1163,1,237,2,235
מורשת,1178,1,611,2,609
מורשת,1178,2,92,0,92
מזור,606,1,495,1,494
מזור,606,2,120,0,120
מזכרת בתיה,28,1,490,4,486
מזכרת בתיה,28,2,424,15,409
מזכרת בתיה,28,3,496,0,496
מזכרת בתיה,28,4,556,0,556
מזכרת בתיה,28,5,442,4,438
מזכרת בתיה,28,6,562,2,560
מזכרת בתיה,28,7,490,2,488
מזכרת בתיה,28,8,339,1,338
מזכרת בתיה,28,9,584,4,580
מזכרת בתיה,28,10,544,8,536
מזכרת בתיה,28,11,322,1,321
מזכרת בתיה,28,12,491,2,489
מזכרת בתיה,28,13,564,1,563
מזכרת בתיה,28,14,599,1,598
מזרע,104,1,247,2,245
מזרע,104,2,230,0,230
מזרעה,517,1,505,2,503
מזרעה,517,2,518,2,516
מזרעה,517,3,533,4,529
מזרעה,517,4,550,4,546
מחולה,3599,1,324,2,322
מחנה טלי,1418,1,110,0,110
מחנה יהודית,1413,1,76,1,75
מחנה יוכבד,1416,1,104,0,104
מחנה יפה,1415,1,176,0,176
מחנה מרים,1414,1,64,0,64
מחנה עדי,1417,1,121,0,121
מחנה תל נוף,1412,1,164,0,164
מחניים,308,1,343,1,342
מחסיה,776,1,229,0,229
מטולה,43,1,509,1,508
מטולה,43,2,415,2,413
מטע,822,1,393,2,391
מי עמי,1128,1,189,1,188
מיטב,2054,1,274,2,272
מייסר,649,1,364,0,364
מייסר,649,2,332,0,332
מירב,1282,1,252,1,251
מירון,607,1,264,0,264
מישר,731,1,377,2,375
מיתר,1268,1,516,2,514
מיתר,1268,2,504,8,496
מיתר,1268,3,537,0,537
מיתר,1268,4,453,3,450
מיתר,1268,5,471,0,471
מיתר,1268,6,560,6,554
מיתר,1268,7,473,0,473
מיתר,1268,8,525,6,519
מיתר,1268,9,373,0,373
מכורה,3614,1,81,0,81
מכחול,1343,1,49,1,48
מכמורת,382,1,324,1,323
מכמורת,382,2,413,2,411
מכמנים,1202,1,213,0,213
מלאה,164,1,208,1,207
מלילות,2044,1,173,2,171
מלכיה,596,1,246,1,245
מנוחה,2030,1,282,0,282
מנוף,1174,1,416,0,416
מנות,1205,1,241,2,239
מנחמיה,48,1,347,3,344
מנחמיה,48,2,271,3,268
מנרה,347,1,138,1,137
מנשית זבדה,994,1,475,4,471
מסד,1258,1,278,2,276
מסדה,263,1,184,0,184
מסילות,298,1,304,0,304
מסילת ציון,742,1,528,1,527
מסלול,748,1,307,0,307
מסעדה,4203,1,26,1,25
מסעודין אל-עזאזמה,939,1,304,2,302
מסעודין אל-עזאזמה,939,2,360,3,357
מסעודין אל-עזאזמה,939,3,301,2,299
מסעודין אל-עזאזמה,939,4,298,4,294
מסעודין אל-עזאזמה,939,5,343,3,340
מסעודין אל-עזאזמה,939,6,251,3,248
מסעודין אל-עזאזמה,939,7,266,2,264
מסעודין אל-עזאזמה,939,8,290,4,286
מסעודין אל-עזאזמה,939,9,262,3,259
מעברות,197,1,287,0,287
מעברות,197,2,294,0,294
מעגלים,1082,1,342,0,342
מעגלים,1082,2,404,0,404
מעגן מיכאל,694,1,390,0,390
מעגן מיכאל,694,2,349,1,348
מעגן מיכאל,694,3,353,1,352
מעגן,678,1,206,0,206
מעוז חיים,272,1,287,1,286
מעון,3657,1,204,0,204
מעונה,570,1,452,3,449
מעטפות חיצוניות,875,1,845,10,835
מעטפות חיצוניות,875,2,860,24,836
מעטפות חיצוניות,875,3,857,6,851
מעטפות חיצוניות,875,4,868,16,852
מעטפות חיצוניות,875,5,907,7,900
מעטפות חיצוניות,875,6,929,10,919
מעטפות חיצוניות,875,7,839,5,834
מעטפות חיצוניות,875,8,906,6,900
מעטפות חיצוניות,875,9,855,26,829
מעטפות חיצוניות,875,10,845,6,839
מעטפות חיצוניות,875,11,861,4,857
מעטפות חיצוניות,875,12,851,6,845
מעטפות חיצוניות,875,13,834,5,829
מעטפות חיצוניות,875,14,847,5,842
מעטפות חיצוניות,875,15,782,15,767
מעטפות חיצוניות,875,16,907,15,892
מעטפות חיצוניות,875,17,847,8,839
מעטפות חיצוניות,875,18,889,7,882
מעטפות חיצוניות,875,19,828,5,823
מעטפות חיצוניות,875,20,895,4,891
מעטפות חיצוניות,875,21,782,5,777
מעטפות חיצוניות,875,22,891,9,882
מעטפות חיצוניות,875,23,897,4,893
מעטפות חיצוניות,875,24,884,16,868
מעטפות חיצוניות,875,25,904,11,893
מעטפות חיצוניות,875,26,901,2,899
מעטפות חיצוניות,875,27,877,1,876
מעטפות חיצוניות,875,28,790,8,782
מעטפות חיצוניות,875,29,860,6,854
מעטפות חיצוניות,875,30,863,1,862
מעטפות חיצוניות,875,31,902,2,900
מעטפות חיצוניות,875,32,846,3,843
מעטפות חיצוניות,875,33,845,2,843
מעטפות חיצוניות,875,34,835,7,828
מעטפות חיצוניות,875,35,853,2,851
מעטפות חיצוניות,875,36,858,1,857
מעטפות חיצוניות,875,37,825,9,816
מעטפות חיצוניות,875,38,827,15,812
מעטפות חיצוניות,875,39,836,5,831
מעטפות חיצוניות,875,40,835,6,829
מעטפות חיצוניות,875,41,850,3,847
מעטפות חיצוניות,875,42,845,1,844
מעטפות חיצוניות,875,43,861,8,853
מעטפות חיצוניות,875,44,849,5,844
מעטפות חיצוניות,875,45,857,0,857
מעטפות חיצוניות,875,46,873,1,872
מעטפות חיצוניות,875,47,839,10,829
מעטפות חיצוניות,875,48,854,5,849
מעטפות חיצוניות,875,49,827,3,824
מעטפות חיצוניות,875,50,799,4,795
מעטפות חיצוניות,875,51,849,3,846
מעטפות חיצוניות,875,52,837,2,835
מעטפות חיצוניות,875,53,843,7,836
מעטפות חיצוניות,875,54,871,1,870
מעטפות חיצוניות,875,55,868,5,863
מעטפות חיצוניות,875,56,866,5,861
מעטפות חיצוניות,875,57,857,3,854
מעטפות חיצוניות,875,58,844,4,840
מעטפות חיצוניות,875,59,867,3,864
מעטפות חיצוניות,875,60,846,2,844
מעטפות חיצוניות,875,61,842,2,840
מעטפות חיצוניות,875,62,850,5,845
מעטפות חיצוניות,875,63,788,11,777
מעטפות חיצוניות,875,64,856,1,855
מעטפות חיצוניות,875,65,826,6,820
מעטפות חיצוניות,875,66,844,7,837
מעטפות חיצוניות,875,67,856,4,852
מעטפות חיצוניות,875,68,840,5,835
מעטפות חיצוניות,875,69,849,9,840
מעטפות חיצוניות,875,70,850,6,844
מעטפות חיצוניות,875,71,865,3,862
מעטפות חיצוניות,875,72,857,2,855
מעטפות חיצוניות,875,73,850,3,847
מעטפות חיצוניות,875,74,833,8,825
מעטפות חיצוניות,875,75,833,5,828
מעטפות חיצוניות,875,76,827,8,819
מעטפות חיצוניות,875,77,853,9,844
מעטפות חיצוניות,875,78,855,7,848
מעטפות חיצוניות,875,79,853,2,851
מעטפות חיצוניות,875,80,853,7,846
מעטפות חיצוניות,875,81,847,5,842
מעטפות חיצוניות,875,82,848,8,840
מעטפות חיצוניות,875,83,838,5,833
מעטפות חיצוניות,875,84,850,3,847
מעטפות חיצוניות,875,85,851,4,847
מעטפות חיצוניות,875,86,868,3,865
מעטפות חיצוניות,875,87,862,1,861
מעטפות חיצוניות,875,88,831,11,820
מעטפות חיצוניות,875,89,879,1,878
מעטפות חיצוניות,875,90,841,4,837
מעטפות חיצוניות,875,91,852,2,850
מעטפות חיצוניות,875,92,853,4,849
מעטפות חיצוניות,875,93,830,2,828
מעטפות חיצוניות,875,94,851,1,850
מעטפות חיצוניות,875,95,825,5,820
מעטפות חיצוניות,875,96,835,5,830
מעטפות חיצוניות,875,97,857,1,856
מעטפות חיצוניות,875,98,847,5,842
מעטפות חיצוניות,875,99,850,6,844
מעטפות חיצוניות,875,100,839,2,837
מעטפות חיצוניות,875,101,867,3,864
מעטפות חיצוניות,875,102,852,1,851
מעטפות חיצוניות,875,103,844,2,842
מעטפות חיצוניות,875,104,828,17,811
מעטפות חיצוניות,875,105,830,5,825
מעטפות חיצוניות,875,106,843,6,837
מעטפות חיצוניות,875,107,824,23,801
מעטפות חיצוניות,875,108,844,1,843
מעטפות חיצוניות,875,109,813,19,794
מעטפות חיצוניות,875,110,723,19,704
מעטפות חיצוניות,875,111,828,13,815
מעטפות חיצוניות,875,112,849,13,836
מעטפות חיצוניות,875,113,849,6,843
מעטפות חיצוניות,875,114,851,7,844
מעטפות חיצוניות,875,115,851,1,850
מעטפות חיצוניות,875,116,831,5,826
מעטפות חיצוניות,875,117,743,2,741
מעטפות חיצוניות,875,118,872,0,872
מעטפות חיצוניות,875,119,853,5,848
מעטפות חיצוניות,875,120,824,5,819
מעטפות חיצוניות,875,121,819,1,818
מעטפות חיצוניות,875,122,842,13,829
מעטפות חיצוניות,875,123,849,0,849
מעטפות חיצוניות,875,124,849,1,848
מעטפות חיצוניות,875,125,822,2,820
מעטפות חיצוניות,875,126,845,6,839
מעטפות חיצוניות,875,127,833,4,829
מעטפות חיצוניות,875,128,851,1,850
מעטפות חיצוניות,875,129,850,4,846
מעטפות חיצוניות,875,130,908,12,896
מעטפות חיצוניות,875,131,898,5,893
מעטפות חיצוניות,875,132,885,2,883
מעטפות חיצוניות,875,133,840,7,833
מעטפות חיצוניות,875,134,892,8,884
מעטפות חיצוניות,875,135,897,5,892
מעטפות חיצוניות,875,136,844,1,843
מעטפות חיצוניות,875,137,854,7,847
מעטפות חיצוניות,875,138,816,3,813
מעטפות חיצוניות,875,139,838,4,834
מעטפות חיצוניות,875,140,848,2,846
מעטפות חיצוניות,875,141,842,2,840
מעטפות חיצוניות,875,142,829,2,827
מעטפות חיצוניות,875,143,870,4,866
מעטפות חיצוניות,875,144,849,5,844
מעטפות חיצוניות,875,145,854,7,847
מעטפות חיצוניות,875,146,856,6,850
מעטפות חיצוניות,875,147,845,9,836
מעטפות חיצוניות,875,148,836,3,833
מעטפות חיצוניות,875,149,825,7,818
מעטפות חיצוניות,875,150,844,10,834
מעטפות חיצוניות,875,151,861,14,847
מעטפות חיצוניות,875,152,829,4,825
מעטפות חיצוניות,875,153,838,16,822
מעטפות חיצוניות,875,154,845,3,842
מעטפות חיצוניות,875,155,827,14,813
מעטפות חיצוניות,875,156,856,8,848
מעטפות חיצוניות,875,157,846,4,842
מעטפות חיצוניות,875,158,827,2,825
מעטפות חיצוניות,875,159,837,8,829
מעטפות חיצוניות,875,161,834,9,825
מעטפות חיצוניות,875,162,837,24,813
מעטפות חיצוניות,875,163,846,19,827
מעטפות חיצוניות,875,164,831,17,814
מעטפות חיצוניות,875,165,859,8,851
מעטפות חיצוניות,875,166,817,3,814
מעטפות חיצוניות,875,167,820,6,814
מעטפות חיצוניות,875,168,829,6,823
מעטפות חיצוניות,875,169,839,7,832
מעטפות חיצוניות,875,170,830,24,806
מעטפות חיצוניות,875,171,813,15,798
מעטפות חיצוניות,875,172,864,11,853
מעטפות חיצוניות,875,173,794,17,777
מעטפות חיצוניות,875,174,842,7,835
מעטפות חיצוניות,875,175,825,5,820
מעטפות חיצוניות,875,176,829,19,810
מעטפות חיצוניות,875,177,805,18,787
מעטפות חיצוניות,875,178,843,11,832
מעטפות חיצוניות,875,179,848,7,841
מעטפות חיצוניות,875,180,847,8,839
מעטפות חיצוניות,875,181,824,19,805
מעטפות חיצוניות,875,182,911,13,898
מעטפות חיצוניות,875,183,840,6,834
מעטפות חיצוניות,875,184,849,12,837
מעטפות חיצוניות,875,186,858,24,834
מעטפות חיצוניות,875,187,836,3,833
מעטפות חיצוניות,875,188,825,17,808
מעטפות חיצוניות,875,189,838,16,822
מעטפות חיצוניות,875,190,814,2,812
מעטפות חיצוניות,875,191,816,2,814
מעטפות חיצוניות,875,192,832,4,828
מעטפות חיצוניות,875,193,849,3,846
מעטפות חיצוניות,875,194,812,6,806
מעטפות חיצוניות,875,195,831,16,815
מעטפות חיצוניות,875,196,818,12,806
מעטפות חיצוניות,875,197,822,13,809
מעטפות חיצוניות,875,198,821,16,805
מעטפות חיצוניות,875,199,800,10,790
מעטפות חיצוניות,875,200,841,16,825
מעטפות חיצוניות,875,201,833,6,827
מעטפות חיצוניות,875,202,826,14,812
מעטפות חיצוניות,875,203,841,11,830
מעטפות חיצוניות,875,204,953,12,941
מעטפות חיצוניות,875,205,834,14,820
מעטפות חיצוניות,875,206,838,4,834
מעטפות חיצוניות,875,207,860,8,852
מעטפות חיצוניות,875,208,839,4,835
מעטפות חיצוניות,875,209,869,5,864
מעטפות חיצוניות,875,210,822,7,815
מעטפות חיצוניות,875,211,835,8,827
מעטפות חיצוניות,875,212,836,5,831
מעטפות חיצוניות,875,213,899,7,892
מעטפות חיצוניות,875,214,831,4,827
מעטפות חיצוניות,875,215,833,10,823
מעטפות חיצוניות,875,216,874,17,857
מעטפות חיצוניות,875,217,1004,8,996
מעטפות חיצוניות,875,218,836,7,829
מעטפות חיצוניות,875,219,847,4,843
מעטפות חיצוניות,875,220,827,10,817
מעטפות חיצוניות,875,221,821,3,818
מעטפות חיצוניות,875,222,843,6,837
מעטפות חיצוניות,875,223,855,0,855
מעטפות חיצוניות,875,224,827,3,824
מעטפות חיצוניות,875,225,784,2,782
מעטפות חיצוניות,875,227,808,4,804
מעטפות חיצוניות,875,228,836,4,832
מעטפות חיצוניות,875,229,828,16,812
מעטפות חיצוניות,875,230,852,8,844
מעטפות חיצוניות,875,231,844,12,832
מעטפות חיצוניות,875,232,759,12,747
מעטפות חיצוניות,875,233,826,7,819
מעטפות חיצוניות,875,234,819,6,813
מעטפות חיצוניות,875,235,840,3,837
מעטפות חיצוניות,875,236,815,1,814
מעטפות חיצוניות,875,237,821,3,818
מעטפות חיצוניות,875,238,817,8,809
מעטפות חיצוניות,875,239,895,7,888
מעטפות חיצוניות,875,240,807,1,806
מעטפות חיצוניות,875,241,857,6,851
מעטפות חיצוניות,875,242,851,3,848
מעטפות חיצוניות,875,243,799,7,792
מעטפות חיצוניות,875,244,815,10,805
מעטפות חיצוניות,875,245,781,11,770
מעטפות חיצוניות,875,246,974,10,964
מעטפות חיצוניות,875,247,795,6,789
מעטפות חיצוניות,875,248,788,4,784
מעטפות חיצוניות,875,249,819,10,809
מעטפות חיצוניות,875,250,835,7,828
מעטפות חיצוניות,875,251,852,10,842
מעטפות חיצוניות,875,252,832,3,829
מעטפות חיצוניות,875,253,825,5,820
מעטפות חיצוניות,875,254,828,6,822
מעטפות חיצוניות,875,255,823,3,820
מעטפות חיצוניות,875,256,939,2,937
מעטפות חיצוניות,875,257,991,4,987
מעטפות חיצוניות,875,258,915,2,913
מעטפות חיצוניות,875,260,800,3,797
מעטפות חיצוניות,875,261,1051,8,1043
מעטפות חיצוניות,875,262,970,1,969
מעטפות חיצוניות,875,263,902,2,900
מעטפות חיצוניות,875,264,857,3,854
מעטפות חיצוניות,875,265,831,9,822
מעטפות חיצוניות,875,266,794,6,788
מעטפות חיצוניות,875,267,789,7,782
מעטפות חיצוניות,875,268,793,2,791
מעטפות חיצוניות,875,271,540,0,540
מעטפות חיצוניות,875,272,831,8,823
מעטפות חיצוניות,875,273,800,4,796
מעטפות חיצוניות,875,274,274,3,271
מעטפות חיצוניות,875,275,787,3,784
מעטפות חיצוניות,875,276,153,2,151
מעטפות חיצוניות,875,277,364,3,361
מעטפות חיצוניות,875,278,299,5,294
מעטפות חיצוניות,875,279,373,5,368
מעטפות חיצוניות,875,280,182,3,179
מעטפות חיצוניות,875,282,384,1,383
מעטפות חיצוניות,875,283,90,1,89
מעטפות חיצוניות,875,284,376,4,372
מעטפות חיצוניות,875,285,438,3,435
מעטפות חיצוניות,875,286,385,1,384
מעטפות חיצוניות,875,287,292,8,284
מעטפות חיצוניות,875,288,382,0,382
מעטפות חיצוניות,875,289,389,7,382
מעטפות חיצוניות,875,290,426,4,422
מעטפות חיצוניות,875,291,170,1,169
מעטפות חיצוניות,875,292,215,2,213
מעטפות חיצוניות,875,293,400,4,396
מעטפות חיצוניות,875,294,355,5,350
מעטפות חיצוניות,875,295,250,3,247
מעטפות חיצוניות,875,296,247,4,243
מעטפות חיצוניות,875,297,330,4,326
מעטפות חיצוניות,875,298,383,15,368
מעטפות חיצוניות,875,299,113,0,113
מעטפות חיצוניות,875,300,129,0,129
מעטפות חיצוניות,875,442,506,4,502
מעטפות חיצוניות,875,445,393,2,391
מעיליא,518,1,451,5,446
מעיליא,518,2,421,2,419
מעיליא,518,3,473,11,462
מעיליא,518,4,420,2,418
מעין ברוך,416,1,347,0,347
מעין צבי,290,1,443,1,442
מעלה אדומים,3616,1,411,4,407
מעלה אדומים,3616,2,350,4,346
מעלה אדומים,3616,3,490,4,486
מעלה אדומים,3616,4,537,2,535
מעלה אדומים,3616,6,407,6,401
מעלה אדומים,3616,7,442,6,436
מעלה אדומים,3616,8,480,1,479
מעלה אדומים,3616,9,439,5,434
מעלה אדומים,3616,10,470,6,464
מעלה אדומים,3616,11,485,8,477
מעלה אדומים,3616,12,520,4,516
מעלה אדומים,3616,13,406,4,402
מעלה אדומים,3616,14,381,1,380
מעלה אדומים,3616,15,400,4,396
מעלה אדומים,3616,16,519,5,514
מעלה אדומים,3616,17,464,4,460
מעלה אדומים,3616,18,505,1,504
מעלה אדומים,3616,19,428,4,424
מעלה אדומים,3616,20,419,1,418
מעלה אדומים,3616,21,468,0,468
מעלה אדומים,3616,22,333,3,330
מעלה אדומים,3616,23,365,2,363
מעלה אדומים,3616,24,595,5,590
מעלה אדומים,3616,25,448,3,445
מעלה אדומים,3616,26,404,5,399
מעלה אדומים,3616,27,486,1,485
מעלה אדומים,3616,28,578,2,576
מעלה אדומים,3616,29,385,0,385
מעלה אדומים,3616,30,461,0,461
מעלה אדומים,3616,31,523,8,515
מעלה אדומים,3616,35,550,5,545
מעלה אדומים,3616,36,490,3,487
מעלה אדומים,3616,37,561,3,558
מעלה אדומים,3616,38,439,0,439
מעלה אדומים,3616,39,464,7,457
מעלה אדומים,3616,40,402,6,396
מעלה אדומים,3616,41,523,3,520
מעלה אדומים,3616,42,605,6,599
מעלה אדומים,3616,43,468,1,467
מעלה אדומים,3616,44,442,2,440
מעלה אדומים,3616,45,487,2,485
מעלה אדומים,3616,950,90,2,88
מעלה אדומים,3616,951,354,4,350
מעלה אדומים,3616,952,535,2,533
מעלה אפרים,3608,1,291,2,289
מעלה אפרים,3608,2,359,8,351
מעלה גלבוע,1127,1,250,1,249
מעלה גמלא,4008,1,252,0,252
מעלה החמישה,286,1,350,1,349
מעלה לבונה,3752,1,291,2,289
מעלה מכמש,3651,1,360,0,360
מעלה מכמש,3651,1,322,1,321
מעלה עירון,1327,1,255,0,255
מעלה עירון,1327,2,468,0,468
מעלה עירון,1327,3,423,0,423
מעלה עירון,1327,4,355,2,353
מעלה עירון,1327,5,316,1,315
מעלה עירון,1327,6,288,0,288
מעלה עירון,1327,7,208,2,206
מעלה עירון,1327,8,422,1,421
מעלה עירון,1327,9,597,2,595
מעלה עירון,1327,10,386,1,385
מעלה עירון,1327,11,291,2,289
מעלה עירון,1327,12,268,0,268
מעלה עירון,1327,13,649,2,647
מעלה עירון,1327,14,310,0,310
מעלה עירון,1327,15,331,0,331
מעלה עמוס,3653,1,163,5,158
מעלה שומרון,3637,1,461,0,461
מעלות-תרשיחא,1063,1,455,9,446
מעלות-תרשיחא,1063,2,333,1,332
מעלות-תרשיחא,1063,3,526,6,520
מעלות-תרשיחא,1063,4,241,0,241
מעלות-תרשיחא,1063,5,471,2,469
מעלות-תרשיחא,1063,6,294,2,292
מעלות-תרשיחא,1063,7,565,13,552
מעלות-תרשיחא,1063,8,412,11,401
מעלות-תרשיחא,1063,9,365,5,360
מעלות-תרשיחא,1063,10,324,18,306
מעלות-תרשיחא,1063,11,393,6,387
מעלות-תרשיחא,1063,12,441,21,420
מעלות-תרשיחא,1063,13,280,13,267
מעלות-תרשיחא,1063,14,471,6,465
מעלות-תרשיחא,1063,15,453,9,444
מעלות-תרשיחא,1063,16,397,7,390
מעלות-תרשיחא,1063,17,423,2,421
מעלות-תרשיחא,1063,18,339,13,326
מעלות-תרשיחא,1063,19,333,3,330
מעלות-תרשיחא,1063,20,268,7,261
מעלות-תרשיחא,1063,21,294,14,280
מעלות-תרשיחא,1063,22,392,6,386
מעלות-תרשיחא,1063,23,346,1,345
מעלות-תרשיחא,1063,24,437,5,432
מעלות-תרשיחא,1063,25,438,8,430
מעלות-תרשיחא,1063,26,452,7,445
מעלות-תרשיחא,1063,28,442,2,440
מעלות-תרשיחא,1063,30,269,3,266
מעלות-תרשיחא,1063,31,343,1,342
מעלות-תרשיחא,1063,32,281,3,278
מעלות-תרשיחא,1063,33,291,2,289
מענית,344,1,410,2,408
מעש,230,1,265,3,262
מעש,230,2,284,1,283
מפלסים,668,1,420,2,418
מצדות יהודה,3745,1,249,0,249
מצובה,325,1,560,2,558
מצליח,757,1,386,2,384
מצליח,757,2,345,0,345
"מצפה אבי""ב",1222,1,492,0,492
מצפה אילן,1370,1,96,0,96
מצפה יריחו,3576,1,470,2,468
מצפה יריחו,3576,2,519,0,519
מצפה נטופה,1190,1,440,1,439
מצפה רמון,99,1,399,8,391
מצפה רמון,99,2,384,4,380
מצפה רמון,99,3,339,8,331
מצפה רמון,99,4,329,3,326
מצפה רמון,99,5,388,5,383
מצפה רמון,99,6,328,0,328
מצפה שלם,3610,1,110,0,110
מצפה,58,1,101,0,101
מצר,648,1,325,0,325
מקווה ישראל,22,1,108,0,108
מרגליות,843,1,175,0,175
מרום גולן,4101,1,355,0,355
מרחב עם,1340,1,109,0,109
מרחביה (מושב),97,1,396,2,394
מרחביה (קיבוץ),66,1,308,4,304
מרחביה (קיבוץ),66,2,324,1,323
מרכז שפירא,1098,1,363,1,362
מרכז שפירא,1098,2,396,0,396
מרכז שפירא,1098,3,404,0,404
משאבי שדה,421,1,318,1,317
משגב דב,765,1,367,1,366
משגב עם,378,1,166,2,164
משהד,520,1,448,6,442
משהד,520,2,542,4,538
משהד,520,3,509,2,507
משהד,520,4,512,0,512
משהד,520,5,469,0,469
משהד,520,6,405,0,405
משהד,520,7,485,0,485
משואה,3605,1,97,1,96
משואות יצחק,620,1,394,1,393
משמר איילון,670,1,308,0,308
משמר דוד,563,1,314,3,311
משמר הירדן,732,1,348,0,348
משמר הנגב,395,1,278,2,276
משמר הנגב,395,2,215,1,214
משמר העמק,130,1,329,1,328
משמר העמק,130,2,347,1,346
משמר השבעה,729,1,494,4,490
משמר השרון,194,1,344,0,344
משמרות,213,1,367,2,365
משמרת,425,1,504,0,504
משען,791,1,486,5,481
מתן,1315,1,573,0,573
מתן,1315,2,532,0,532
מתן,1315,3,367,2,365
מתן,1315,4,356,2,354
מתת,1184,1,110,4,106
מתתיהו,3648,1,225,7,218
נאות גולן,4551,1,256,3,253
נאות הכיכר,1124,1,136,0,136
נאות מרדכי,408,1,340,0,340
נאות סמדר,1197,1,201,0,201
נאעורה,524,1,416,6,410
נאעורה,524,2,367,7,360
נבטים,396,1,481,3,478
נגבה,315,1,430,0,430
נגוהות,3724,1,82,0,82
נהורה,309,1,316,0,316
נהורה,309,2,360,3,357
נהלל,80,1,256,0,256
נהלל,80,2,263,1,262
נהריה,9100,1,470,4,466
נהריה,9100,2,435,5,430
נהריה,9100,3,406,3,403
נהריה,9100,4,507,0,507
נהריה,9100,5,488,3,485
נהריה,9100,6,387,7,380
נהריה,9100,7,464,6,458
נהריה,9100,11,360,14,346
נהריה,9100,12,392,3,389
נהריה,9100,13,359,6,353
נהריה,9100,14,318,3,315
נהריה,9100,15,314,1,313
נהריה,9100,16,297,3,294
נהריה,9100,17,310,6,304
נהריה,9100,18,360,10,350
נהריה,9100,19,365,2,363
נהריה,9100,20,363,12,351
נהריה,9100,21,389,12,377
נהריה,9100,22,312,5,307
נהריה,9100,23,399,2,397
נהריה,9100,24,327,1,326
נהריה,9100,29,493,4,489
נהריה,9100,30,576,7,569
נהריה,9100,31,458,9,449
נהריה,9100,32,351,4,347
נהריה,9100,33,424,2,422
נהריה,9100,34,313,4,309
נהריה,9100,35,494,12,482
נהריה,9100,36,418,6,412
נהריה,9100,37,394,4,390
נהריה,9100,38,360,5,355
נהריה,9100,39,373,4,369
נהריה,9100,40,481,3,478
נהריה,9100,41,402,7,395
נהריה,9100,42,406,3,403
נהריה,9100,43,396,3,393
נהריה,9100,44,542,3,539
נהריה,9100,45,389,3,386
נהריה,9100,46,214,10,204
נהריה,9100,47,361,3,358
נהריה,9100,48,442,5,437
נהריה,9100,49,467,8,459
נהריה,9100,50,497,6,491
נהריה,9100,51,287,5,282
נהריה,9100,52,307,6,301
נהריה,9100,53,487,6,481
נהריה,9100,54,446,4,442
נהריה,9100,55,509,3,506
נהריה,9100,56,402,2,400
נהריה,9100,57,404,2,402
נהריה,9100,58,458,5,453
נהריה,9100,59,448,3,445
נהריה,9100,60,542,3,539
נהריה,9100,61,419,5,414
נהריה,9100,62,489,2,487
נהריה,9100,63,391,1,390
נהריה,9100,64,486,4,482
נהריה,9100,65,438,1,437
נהריה,9100,66,434,0,434
נהריה,9100,67,478,0,478
נהריה,9100,68,543,3,540
נהריה,9100,69,438,0,438
נהריה,9100,70,396,4,392
נהריה,9100,71,407,5,402
נהריה,9100,72,317,6,311
נהריה,9100,73,313,0,313
נהריה,9100,74,445,0,445
נהריה,9100,75,274,1,273
נהריה,9100,76,350,2,348
נהריה,9100,77,494,7,487
נהריה,9100,78,337,1,336
נהריה,9100,79,389,0,389
נהריה,9100,80,499,5,494
נהריה,9100,81,365,20,345
נהריה,9100,82,261,5,256
נהריה,9100,83,352,4,348
נוב,4304,1,381,1,380
נוגה,55,1,278,1,277
נווה אור,590,1,218,1,217
"נווה אטי""ב",4303,1,110,2,108
נווה אילן,405,1,493,1,492
נווה איתן,296,1,141,1,140
נווה דניאל,3725,1,517,0,517
נווה דניאל,3725,2,576,4,572
נווה זוהר,1057,1,40,0,40
נווה זיו,1314,1,310,1,309
נווה ים,312,1,163,0,163
נווה ימין,686,1,386,3,383
נווה ימין,686,2,353,1,352
נווה ירק,858,1,338,2,336
נווה ירק,858,2,367,3,364
נווה מבטח,827,1,333,0,333
נווה מיכאל,1071,1,279,1,278
נווה שלום,1259,1,136,0,136
נווה,1366,1,286,0,286
נועם,15,1,230,2,228
נוף איילון,1333,1,626,1,625
נוף איילון,1333,2,437,0,437
נוף איילון,1333,3,279,2,277
נופים,3790,1,311,2,309
נופית,1284,1,399,1,398
נופית,1284,2,517,0,517
נופית,1284,3,637,1,636
נופך,257,1,263,0,263
נוקדים,3726,1,543,3,540
נוקדים,3726,2,217,1,216
נורדיה,447,1,434,3,431
נורדיה,447,2,369,0,369
נורדיה,447,3,540,6,534
נחושה,59,1,443,1,442
נחל עוז,844,1,222,0,222
נחלה,2045,1,337,2,335
נחליאל,3767,1,245,1,244
נחלים,449,1,443,1,442
נחלים,449,2,305,1,304
נחם,809,1,355,3,352
נחף,522,1,555,0,555
נחף,522,2,486,0,486
נחף,522,3,493,0,493
נחף,522,4,527,2,525
נחף,522,5,502,0,502
נחף,522,6,475,6,469
נחף,522,7,528,4,524
נחף,522,8,476,2,474
נחף,522,9,521,7,514
נחף,522,10,543,1,542
נחשולים,433,1,408,1,407
נחשון,777,1,308,4,304
נחשונים,705,1,211,1,210
נטועה,1147,1,182,1,181
נטור,4014,1,150,0,150
נטע,1369,1,139,1,138
נטעים,174,1,380,0,380
נטף,1254,1,257,0,257
ניין,523,1,514,3,511
ניין,523,2,383,7,376
"ניל""י",3655,1,479,2,477
"ניל""י",3655,2,192,0,192
ניצן ב',1419,1,290,2,288
ניצן ב',1419,2,422,3,419
ניצן ב',1419,3,257,0,257
ניצן,351,1,375,0,375
ניצן,351,2,369,0,369
ניצנה (קהילת חינו,1195,1,75,1,74
ניצני סיני,1280,1,115,1,114
ניצני עוז,851,1,557,1,556
ניצנים,359,1,262,2,260
ניר אליהו,808,1,293,1,292
ניר בנים,553,1,434,3,431
ניר גלים,720,1,468,1,467
ניר דוד (תל עמל),256,1,444,0,444
"ניר ח""ן",11,1,262,1,261
ניר יפה,165,1,307,0,307
ניר יצחק,402,1,381,0,381
ניר ישראל,699,1,439,0,439
ניר משה,2047,1,281,1,280
ניר עוז,69,1,269,1,268
ניר עם,348,1,216,1,215
ניר עציון,769,1,300,1,299
ניר עקיבא,2048,1,315,1,314
ניר צבי,331,1,321,1,320
ניר צבי,331,2,374,1,373
נירים,602,1,280,0,280
נירית,1236,1,397,0,397
נירית,1236,2,377,0,377
נירן,3620,1,55,0,55
נס הרים,825,1,521,1,520
נס ציונה,7200,1,593,3,590
נס ציונה,7200,2,329,8,321
נס ציונה,7200,3,398,6,392
נס ציונה,7200,4,554,8,546
נס ציונה,7200,5,524,2,522
נס ציונה,7200,6,499,0,499
נס ציונה,7200,7,571,2,569
נס ציונה,7200,8,496,5,491
נס ציונה,7200,9,366,0,366
נס ציונה,7200,10,382,1,381
נס ציונה,7200,11,480,3,477
נס ציונה,7200,12,490,4,486
נס ציונה,7200,13,504,4,500
נס ציונה,7200,15,408,6,402
נס ציונה,7200,16,544,1,543
נס ציונה,7200,17,571,1,570
נס ציונה,7200,18,359,7,352
נס ציונה,7200,19,393,3,390
נס ציונה,7200,20,388,2,386
נס ציונה,7200,21,387,2,385
נס ציונה,7200,22,580,3,577
נס ציונה,7200,23,494,4,490
נס ציונה,7200,24,595,4,591
נס ציונה,7200,25,460,4,456
נס ציונה,7200,26,574,2,572
נס ציונה,7200,27,294,5,289
נס ציונה,7200,28,593,4,589
נס ציונה,7200,30,438,3,435
נס ציונה,7200,31,462,1,461
נס ציונה,7200,32,333,8,325
נס ציונה,7200,33,360,16,344
נס ציונה,7200,35,579,5,574
נס ציונה,7200,36,551,1,550
נס ציונה,7200,37,530,5,525
נס ציונה,7200,50,466,2,464
נס ציונה,7200,51,434,9,425
נס ציונה,7200,52,267,2,265
נס ציונה,7200,53,404,2,402
נס ציונה,7200,54,292,7,285
נס ציונה,7200,56,487,0,487
נס ציונה,7200,57,615,0,615
נס ציונה,7200,58,576,2,574
נס ציונה,7200,59,501,0,501
נס ציונה,7200,60,515,2,513
נס ציונה,7200,61,365,0,365
נס ציונה,7200,62,517,3,514
נס ציונה,7200,63,340,0,340
נס ציונה,7200,64,588,2,586
נס ציונה,7200,65,622,3,619
נס ציונה,7200,951,625,0,625
נס ציונה,7200,952,422,0,422
נעורים,186,1,79,0,79
נעלה,3787,1,634,5,629
"נעמ""ה",3713,1,77,0,77
נען,158,1,436,1,435
נען,158,2,469,4,465
נצאצרה (שבט),1041,1,152,5,147
נצר חזני,1372,1,170,0,170
נצר סרני,435,1,437,0,437
נצרת עילית,1061,1,509,6,503
נצרת עילית,1061,2,303,4,299
נצרת עילית,1061,3,436,14,422
נצרת עילית,1061,4,291,9,282
נצרת עילית,1061,5,405,5,400
נצרת עילית,1061,6,356,1,355
נצרת עילית,1061,7,260,2,258
נצרת עילית,1061,8,91,1,90
נצרת עילית,1061,9,385,6,379
נצרת עילית,1061,10,335,8,327
נצרת עילית,1061,11,333,7,326
נצרת עילית,1061,13,352,9,343
נצרת עילית,1061,14,339,14,325
נצרת עילית,1061,15,283,6,277
נצרת עילית,1061,16,366,10,356
נצרת עילית,1061,17,197,4,193
נצרת עילית,1061,18,213,6,207
נצרת עילית,1061,19,382,3,379
נצרת עילית,1061,20,272,4,268
נצרת עילית,1061,21,265,13,252
נצרת עילית,1061,22,225,4,221
נצרת עילית,1061,23,330,19,311
נצרת עילית,1061,24,333,4,329
נצרת עילית,1061,25,375,8,367
נצרת עילית,1061,26,291,7,284
נצרת עילית,1061,27,335,12,323
נצרת עילית,1061,28,387,7,380
נצרת עילית,1061,29,273,6,267
נצרת עילית,1061,30,311,9,302
נצרת עילית,1061,31,222,5,217
נצרת עילית,1061,32,315,9,306
נצרת עילית,1061,33,281,5,276
נצרת עילית,1061,34,230,14,216
נצרת עילית,1061,35,281,1,280
נצרת עילית,1061,36,470,9,461
נצרת עילית,1061,37,444,16,428
נצרת עילית,1061,38,345,7,338
נצרת עילית,1061,39,425,2,423
נצרת עילית,1061,40,466,7,459
נצרת עילית,1061,41,342,10,332
נצרת עילית,1061,42,440,6,434
נצרת עילית,1061,43,346,9,337
נצרת עילית,1061,44,392,7,385
נצרת עילית,1061,45,287,4,283
נצרת עילית,1061,46,377,2,375
נצרת עילית,1061,47,409,3,406
נצרת עילית,1061,48,199,8,191
נצרת עילית,1061,49,325,6,319
נצרת עילית,1061,50,377,3,374
נצרת עילית,1061,51,396,11,385
נצרת עילית,1061,52,264,15,249
נצרת עילית,1061,53,302,4,298
נצרת עילית,1061,55,500,10,490
נצרת עילית,1061,56,471,1,470
נצרת עילית,1061,57,291,15,276
נצרת עילית,1061,58,313,7,306
נצרת עילית,1061,59,216,5,211
נצרת עילית,1061,70,405,11,394
נצרת עילית,1061,71,439,12,427
נצרת עילית,1061,72,384,7,377
נצרת עילית,1061,73,458,14,444
נצרת עילית,1061,74,423,3,420
נצרת עילית,1061,75,372,6,366
נצרת עילית,1061,76,360,5,355
נצרת עילית,1061,77,318,5,313
נצרת עילית,1061,951,468,0,468
נצרת,7300,1,467,4,463
נצרת,7300,2,356,5,351
נצרת,7300,3,336,3,333
נצרת,7300,4,400,2,398
נצרת,7300,5,427,7,420
נצרת,7300,6,442,2,440
נצרת,7300,7,495,2,493
נצרת,7300,8,448,3,445
נצרת,7300,9,454,0,454
נצרת,7300,10,431,1,430
נצרת,7300,11,348,0,348
נצרת,7300,13,336,3,333
נצרת,7300,14,254,2,252
נצרת,7300,15,446,6,440
נצרת,7300,16,313,2,311
נצרת,7300,17,335,5,330
נצרת,7300,18,295,0,295
נצרת,7300,19,352,5,347
נצרת,7300,20,254,1,253
נצרת,7300,21,376,2,374
נצרת,7300,22,538,4,534
נצרת,7300,23,424,3,421
נצרת,7300,24,439,3,436
נצרת,7300,25,425,4,421
נצרת,7300,26,393,2,391
נצרת,7300,27,311,0,311
נצרת,7300,28,455,3,452
נצרת,7300,29,354,3,351
נצרת,7300,30,462,0,462
נצרת,7300,31,363,6,357
נצרת,7300,32,536,1,535
נצרת,7300,33,359,0,359
נצרת,7300,34,363,2,361
נצרת,7300,35,297,0,297
נצרת,7300,36,531,3,528
נצרת,7300,37,468,7,461
נצרת,7300,38,377,1,376
נצרת,7300,39,393,2,391
נצרת,7300,40,384,2,382
נצרת,7300,41,456,64,392
נצרת,7300,42,410,1,409
נצרת,7300,43,274,0,274
נצרת,7300,44,259,2,257
נצרת,7300,45,510,1,509
נצרת,7300,46,395,3,392
נצרת,7300,47,292,0,292
נצרת,7300,48,399,7,392
נצרת,7300,49,476,1,475
נצרת,7300,50,443,6,437
נצרת,7300,51,433,2,431
נצרת,7300,52,492,1,491
נצרת,7300,53,453,4,449
נצרת,7300,54,406,2,404
נצרת,7300,55,427,2,425
נצרת,7300,56,375,6,369
נצרת,7300,57,437,4,433
נצרת,7300,58,362,11,351
נצרת,7300,59,460,1,459
נצרת,7300,60,448,4,444
נצרת,7300,61,361,1,360
נצרת,7300,62,395,0,395
נצרת,7300,63,387,4,383
נצרת,7300,64,353,0,353
נצרת,7300,65,379,7,372
נצרת,7300,66,339,1,338
נצרת,7300,67,520,5,515
נצרת,7300,68,443,0,443
נצרת,7300,69,391,0,391
נצרת,7300,70,426,1,425
נצרת,7300,71,377,1,376
נצרת,7300,72,403,0,403
נצרת,7300,73,328,1,327
נצרת,7300,74,536,2,534
נצרת,7300,75,463,12,451
נצרת,7300,80,324,4,320
נצרת,7300,81,386,14,372
נצרת,7300,82,340,3,337
נצרת,7300,83,291,2,289
נצרת,7300,84,320,0,320
נצרת,7300,85,189,3,186
נצרת,7300,86,363,1,362
נצרת,7300,87,305,3,302
נצרת,7300,950,426,2,424
נשר,2500,1,331,1,330
נשר,2500,2,325,2,323
נשר,2500,3,411,7,404
נשר,2500,4,428,4,424
נשר,2500,5,238,9,229
נשר,2500,6,399,3,396
נשר,2500,7,377,13,364
נשר,2500,8,235,6,229
נשר,2500,9,376,8,368
נשר,2500,10,288,5,283
נשר,2500,11,414,15,399
נשר,2500,12,227,2,225
נשר,2500,13,317,9,308
נשר,2500,14,308,2,306
נשר,2500,16,424,8,416
נשר,2500,19,507,3,504
נשר,2500,20,370,1,369
נשר,2500,21,545,11,534
נשר,2500,22,483,2,481
נשר,2500,23,502,4,498
נשר,2500,24,418,1,417
נשר,2500,25,430,9,421
נשר,2500,26,504,1,503
נשר,2500,27,502,3,499
נשר,2500,28,390,6,384
נשר,2500,29,470,1,469
נשר,2500,30,432,2,430
נשר,2500,31,468,7,461
נשר,2500,32,289,19,270
נשר,2500,33,494,2,492
נשר,2500,34,417,2,415
נשר,2500,35,680,2,678
נתיב הגדוד,3555,1,105,0,105
"נתיב הל""ה",693,1,321,0,321
נתיב העשרה,1242,1,502,2,500
נתיב השיירה,792,1,324,1,323
נתיבות,246,1,512,10,502
נתיבות,246,2,439,2,437
נתיבות,246,3,392,2,390
נתיבות,246,4,453,8,445
נתיבות,246,5,382,5,377
נתיבות,246,6,460,10,450
נתיבות,246,7,367,2,365
נתיבות,246,8,358,6,352
נתיבות,246,9,530,6,524
נתיבות,246,10,367,2,365
נתיבות,246,11,316,7,309
נתיבות,246,12,460,9,451
נתיבות,246,13,469,5,464
נתיבות,246,14,602,5,597
נתיבות,246,15,434,2,432
נתיבות,246,16,492,9,483
נתיבות,246,17,366,3,363
נתיבות,246,18,546,9,537
נתיבות,246,19,464,10,454
נתיבות,246,20,404,1,403
נתיבות,246,21,546,5,541
נתיבות,246,22,586,0,586
נתיבות,246,23,667,1,666
נתיבות,246,24,545,2,543
נתיבות,246,25,460,5,455
נתיבות,246,26,548,3,545
נתיבות,246,27,561,5,556
נתיבות,246,28,435,4,431
נתיבות,246,30,590,7,583
נתיבות,246,31,385,13,372
נתיבות,246,32,627,2,625
נתניה,7400,1,449,6,443
נתניה,7400,2,477,3,474
נתניה,7400,3,371,6,365
נתניה,7400,4,360,11,349
נתניה,7400,5,406,1,405
נתניה,7400,6,407,2,405
נתניה,7400,7,355,4,351
נתניה,7400,8,405,11,394
נתניה,7400,9,304,6,298
נתניה,7400,10,377,4,373
נתניה,7400,11,336,8,328
נתניה,7400,12,414,4,410
נתניה,7400,13,447,1,446
נתניה,7400,14,493,7,486
נתניה,7400,15,305,3,302
נתניה,7400,16,487,8,479
נתניה,7400,17,426,7,419
נתניה,7400,18,474,5,469
נתניה,7400,19,391,8,383
נתניה,7400,20,262,6,256
נתניה,7400,21,404,7,397
נתניה,7400,22,318,2,316
נתניה,7400,23,417,5,412
נתניה,7400,24,412,6,406
נתניה,7400,25,458,3,455
נתניה,7400,26,390,0,390
נתניה,7400,27,437,2,435
נתניה,7400,28,521,2,519
נתניה,7400,29,389,8,381
נתניה,7400,30,295,4,291
נתניה,7400,31,390,8,382
נתניה,7400,32,306,4,302
נתניה,7400,33,297,6,291
נתניה,7400,34,230,4,226
נתניה,7400,35,265,2,263
נתניה,7400,36,283,0,283
נתניה,7400,37,227,8,219
נתניה,7400,38,314,3,311
נתניה,7400,39,300,3,297
נתניה,7400,40,250,5,245
נתניה,7400,41,309,5,304
נתניה,7400,42,290,5,285
נתניה,7400,43,242,10,232
נתניה,7400,44,326,5,321
נתניה,7400,45,206,2,204
נתניה,7400,46,446,3,443
נתניה,7400,47,521,0,521
נתניה,7400,48,354,6,348
נתניה,7400,49,431,4,427
נתניה,7400,50,277,3,274
נתניה,7400,51,346,5,341
נתניה,7400,52,438,4,434
נתניה,7400,53,326,2,324
נתניה,7400,54,323,5,318
נתניה,7400,55,357,7,350
נתניה,7400,56,426,11,415
נתניה,7400,57,507,8,499
נתניה,7400,58,318,5,313
נתניה,7400,59,409,8,401
נתניה,7400,60,402,4,398
נתניה,7400,61,345,6,339
נתניה,7400,62,542,4,538
נתניה,7400,63,417,3,414
נתניה,7400,64,542,16,526
נתניה,7400,65,450,0,450
נתניה,7400,66,513,13,500
נתניה,7400,67,248,2,246
נתניה,7400,68,439,6,433
נתניה,7400,69,421,6,415
נתניה,7400,70,557,5,552
נתניה,7400,71,402,3,399
נתניה,7400,72,479,2,477
נתניה,7400,73,507,3,504
נתניה,7400,74,558,4,554
נתניה,7400,75,427,8,419
נתניה,7400,76,342,2,340
נתניה,7400,77,435,1,434
נתניה,7400,78,443,5,438
נתניה,7400,79,471,8,463
נתניה,7400,80,243,3,240
נתניה,7400,81,344,6,338
נתניה,7400,82,408,0,408
נתניה,7400,83,370,12,358
נתניה,7400,84,458,7,451
נתניה,7400,85,362,2,360
נתניה,7400,86,343,9,334
נתניה,7400,87,282,6,276
נתניה,7400,88,448,13,435
נתניה,7400,89,507,4,503
נתניה,7400,90,409,7,402
נתניה,7400,91,285,3,282
נתניה,7400,92,358,5,353
נתניה,7400,93,314,4,310
נתניה,7400,94,241,9,232
נתניה,7400,95,351,8,343
נתניה,7400,96,366,5,361
נתניה,7400,97,291,3,288
נתניה,7400,98,245,5,240
נתניה,7400,99,302,3,299
נתניה,7400,100,346,5,341
נתניה,7400,101,237,6,231
נתניה,7400,102,284,3,281
נתניה,7400,103,276,1,275
נתניה,7400,104,306,11,295
נתניה,7400,105,234,1,233
נתניה,7400,106,269,1,268
נתניה,7400,107,288,10,278
נתניה,7400,108,405,10,395
נתניה,7400,109,282,5,277
נתניה,7400,110,374,7,367
נתניה,7400,111,438,7,431
נתניה,7400,112,402,2,400
נתניה,7400,113,415,2,413
נתניה,7400,114,362,4,358
נתניה,7400,115,472,2,470
נתניה,7400,116,410,6,404
נתניה,7400,117,333,3,330
נתניה,7400,118,453,7,446
נתניה,7400,119,458,7,451
נתניה,7400,120,378,4,374
נתניה,7400,121,344,4,340
נתניה,7400,122,305,2,303
נתניה,7400,123,476,2,474
נתניה,7400,124,265,1,264
נתניה,7400,125,354,6,348
נתניה,7400,126,456,6,450
נתניה,7400,127,324,5,319
נתניה,7400,128,371,3,368
נתניה,7400,129,327,0,327
נתניה,7400,130,440,10,430
נתניה,7400,131,376,2,374
נתניה,7400,132,402,10,392
נתניה,7400,133,309,4,305
נתניה,7400,134,365,7,358
נתניה,7400,135,316,4,312
נתניה,7400,136,383,3,380
נתניה,7400,137,247,2,245
נתניה,7400,138,284,4,280
נתניה,7400,139,228,3,225
נתניה,7400,140,236,3,233
נתניה,7400,141,259,4,255
נתניה,7400,142,351,2,349
נתניה,7400,143,399,5,394
נתניה,7400,144,319,3,316
נתניה,7400,145,175,8,167
נתניה,7400,146,345,7,338
נתניה,7400,147,508,2,506
נתניה,7400,148,361,5,356
נתניה,7400,149,322,7,315
נתניה,7400,150,273,8,265
נתניה,7400,151,285,5,280
נתניה,7400,152,278,3,275
נתניה,7400,153,291,4,287
נתניה,7400,154,407,3,404
נתניה,7400,155,520,11,509
נתניה,7400,156,523,6,517
נתניה,7400,157,277,8,269
נתניה,7400,158,363,12,351
נתניה,7400,159,350,4,346
נתניה,7400,160,528,4,524
נתניה,7400,161,396,2,394
נתניה,7400,162,455,2,453
נתניה,7400,163,366,0,366
נתניה,7400,164,451,5,446
נתניה,7400,165,281,6,275
נתניה,7400,166,457,9,448
נתניה,7400,167,559,6,553
נתניה,7400,168,546,1,545
נתניה,7400,169,354,5,349
נתניה,7400,170,361,10,351
נתניה,7400,171,301,2,299
נתניה,7400,172,339,2,337
נתניה,7400,173,508,5,503
נתניה,7400,174,226,4,222
נתניה,7400,175,525,8,517
נתניה,7400,176,375,1,374
נתניה,7400,177,263,7,256
נתניה,7400,178,449,3,446
נתניה,7400,179,214,5,209
נתניה,7400,180,345,8,337
נתניה,7400,181,507,8,499
נתניה,7400,182,457,12,445
נתניה,7400,183,343,7,336
נתניה,7400,184,297,1,296
נתניה,7400,185,403,1,402
נתניה,7400,186,196,2,194
נתניה,7400,187,327,5,322
נתניה,7400,188,549,8,541
נתניה,7400,189,326,5,321
נתניה,7400,190,324,2,322
נתניה,7400,191,449,4,445
נתניה,7400,192,356,3,353
נתניה,7400,193,627,2,625
נתניה,7400,194,265,3,262
נתניה,7400,195,252,10,242
נתניה,7400,196,268,4,264
נתניה,7400,197,458,3,455
נתניה,7400,198,340,5,335
נתניה,7400,199,338,6,332
נתניה,7400,200,299,7,292
נתניה,7400,201,343,3,340
נתניה,7400,202,544,2,542
נתניה,7400,203,472,2,470
נתניה,7400,204,399,6,393
נתניה,7400,205,342,0,342
נתניה,7400,206,512,1,511
נתניה,7400,207,481,5,476
נתניה,7400,208,521,3,518
נתניה,7400,209,457,10,447
נתניה,7400,210,361,2,359
נתניה,7400,211,381,1,380
נתניה,7400,212,577,0,577
נתניה,7400,213,438,7,431
נתניה,7400,214,470,2,468
נתניה,7400,215,489,4,485
נתניה,7400,216,440,2,438
נתניה,7400,217,485,5,480
נתניה,7400,218,445,3,442
נתניה,7400,219,531,3,528
נתניה,7400,220,368,9,359
נתניה,7400,221,401,2,399
נתניה,7400,222,455,4,451
נתניה,7400,223,316,6,310
נתניה,7400,224,168,3,165
נתניה,7400,225,546,3,543
נתניה,7400,226,567,6,561
נתניה,7400,227,480,1,479
נתניה,7400,228,217,8,209
נתניה,7400,229,496,1,495
נתניה,7400,230,515,4,511
נתניה,7400,231,390,4,386
נתניה,7400,232,477,3,474
נתניה,7400,233,431,1,430
נתניה,7400,234,586,2,584
נתניה,7400,235,445,3,442
נתניה,7400,236,328,15,313
נתניה,7400,237,329,4,325
נתניה,7400,238,289,3,286
נתניה,7400,239,405,4,401
נתניה,7400,240,387,2,385
נתניה,7400,241,447,6,441
נתניה,7400,242,356,3,353
נתניה,7400,243,144,2,142
נתניה,7400,244,356,5,351
נתניה,7400,245,259,4,255
נתניה,7400,246,298,2,296
נתניה,7400,247,570,5,565
נתניה,7400,248,607,1,606
נתניה,7400,249,544,6,538
נתניה,7400,250,307,4,303
נתניה,7400,251,551,6,545
נתניה,7400,252,624,2,622
נתניה,7400,253,512,2,510
נתניה,7400,254,465,6,459
נתניה,7400,255,543,0,543
נתניה,7400,256,420,6,414
נתניה,7400,257,174,0,174
נתניה,7400,259,539,0,539
נתניה,7400,260,367,1,366
נתניה,7400,261,341,6,335
נתניה,7400,262,470,3,467
נתניה,7400,263,339,2,337
נתניה,7400,264,325,4,321
נתניה,7400,265,597,2,595
נתניה,7400,266,646,2,644
נתניה,7400,267,438,1,437
נתניה,7400,268,224,2,222
נתניה,7400,269,470,4,466
נתניה,7400,952,471,4,467
נתניה,7400,954,541,4,537
נתניה,7400,955,576,4,572
נתניה,7400,956,468,6,462
נתניה,7400,957,508,9,499
נתניה,7400,958,384,8,376
נתניה,7400,959,489,8,481
סאג'ור,525,1,407,2,405
סאג'ור,525,2,363,2,361
סאג'ור,525,3,317,5,312
סאג'ור,525,4,351,1,350
סאסא,578,1,338,0,338
סביון,587,1,406,2,404
סביון,587,2,518,1,517
סביון,587,3,410,3,407
סביון,587,4,483,0,483
סביון,587,101,293,1,292
סביון,587,102,295,2,293
סגולה,2046,1,324,0,324
סואעד (חמרייה),942,1,48,0,48
סולם,526,1,325,2,323
סולם,526,2,338,2,336
סולם,526,3,372,2,370
סולם,526,4,303,8,295
סוסיה,3756,1,429,3,426
סופה,1238,1,144,0,144
סח'נין,7500,1,612,4,608
סח'נין,7500,2,599,2,597
סח'נין,7500,3,548,2,546
סח'נין,7500,4,612,0,612
סח'נין,7500,5,535,6,529
סח'נין,7500,6,531,1,530
סח'נין,7500,7,527,0,527
סח'נין,7500,8,582,1,581
סח'נין,7500,9,547,0,547
סח'נין,7500,10,563,0,563
סח'נין,7500,11,541,0,541
סח'נין,7500,12,583,3,580
סח'נין,7500,13,566,3,563
סח'נין,7500,14,551,1,550
סח'נין,7500,15,555,2,553
סח'נין,7500,16,548,0,548
סח'נין,7500,17,504,0,504
סח'נין,7500,18,576,0,576
סח'נין,7500,19,578,0,578
סח'נין,7500,20,612,0,612
סח'נין,7500,21,574,0,574
סח'נין,7500,22,555,1,554
סח'נין,7500,23,569,3,566
סח'נין,7500,24,607,2,605
סח'נין,7500,25,565,4,561
סח'נין,7500,26,590,4,586
סח'נין,7500,27,501,10,491
סייד (שבט),1170,1,197,1,196
סייד (שבט),1170,2,226,0,226
סייד (שבט),1170,3,236,3,233
סלמה,1245,1,294,2,292
סלמה,1245,2,403,3,400
סלמה,1245,3,321,6,315
סלעית,3567,1,318,1,317
סמר,1156,1,193,1,192
סנסנה,3777,1,145,0,145
סעד,419,1,477,1,476
סער,454,1,401,0,401
ספיר,1176,1,197,1,196
סתריה,610,1,324,2,322
סתריה,610,2,283,0,283
ע'ג'ר,4501,1,316,6,310
ע'ג'ר,4501,2,374,0,374
עבדון,892,1,342,3,339
עברון,376,1,242,2,240
עברון,376,2,247,2,245
עגור,794,1,208,1,207
עדי,1199,1,500,0,500
עדי,1199,2,582,0,582
עדנים,2035,1,229,0,229
עוזה,826,1,294,2,292
עוזייר,528,1,281,7,274
עוזייר,528,2,315,0,315
עוזייר,528,3,345,2,343
עולש,737,1,296,0,296
עולש,737,2,249,2,247
עומר,666,1,487,1,486
עומר,666,2,463,1,462
עומר,666,3,426,1,425
עומר,666,4,483,1,482
עומר,666,5,395,1,394
עומר,666,6,345,1,344
עומר,666,7,281,3,278
עומר,666,7,257,3,254
עומר,666,8,360,0,360
עומר,666,9,348,1,347
עומר,666,10,417,1,416
עומר,666,11,450,0,450
עופר,810,1,311,0,311
עופרה,3617,1,605,3,602
עופרה,3617,2,547,3,544
עופרה,3617,3,333,0,333
עוצם,32,1,323,1,322
עוקבי (בנו עוקבה),957,1,164,1,163
עזר,1149,1,498,1,497
עזריאל,837,1,454,3,451
עזריה,711,1,577,3,574
עזריקם,817,1,312,2,310
עזריקם,817,2,335,1,334
עטאוונה (שבט),969,1,57,0,57
עטרת,3658,1,244,0,244
עידן,1175,1,173,0,173
עיילבון,530,1,397,6,391
עיילבון,530,2,423,7,416
עיילבון,530,3,491,1,490
עיילבון,530,4,485,0,485
עיילבון,530,5,423,3,420
עיילבון,530,6,451,3,448
עיינות,156,1,52,1,51
עילוט,511,1,340,2,338
עילוט,511,2,350,8,342
עילוט,511,3,282,9,273
עילוט,511,4,281,5,276
עילוט,511,5,235,9,226
עילוט,511,6,249,3,246
עילוט,511,7,204,3,201
עין איילה,687,1,517,1,516
עין אל-אסד,546,1,281,3,278
עין גב,273,1,317,0,317
עין גדי,2042,1,297,3,294
עין דור,436,1,272,1,271
עין דור,436,2,312,0,312
עין הבשור,1240,1,517,1,516
עין הוד,74,1,337,1,336
עין החורש,167,1,267,0,267
עין החורש,167,2,269,2,267
עין המפרץ,289,1,257,0,257
עין המפרץ,289,2,252,0,252
"עין הנצי""ב",383,1,333,0,333
עין העמק,367,1,419,3,416
עין השופט,270,1,250,0,250
עין השופט,270,2,291,1,290
עין השלושה,676,1,224,1,223
עין ורד,157,1,448,0,448
עין ורד,157,2,397,1,396
עין זיוון,4503,1,155,1,154
עין חוד,1320,1,109,1,108
עין חרוד (איחוד),89,1,182,0,182
עין חרוד (איחוד),89,2,229,1,228
עין חרוד (מאוחד),82,1,238,1,237
עין חרוד (מאוחד),82,2,247,1,246
עין יהב,806,1,384,3,381
עין יעקב,813,1,470,1,469
עין כרמל,426,1,376,1,375
עין מאהל,532,1,552,2,550
עין מאהל,532,2,455,3,452
עין מאהל,532,3,544,3,541
עין מאהל,532,4,522,3,519
עין מאהל,532,5,553,2,551
עין מאהל,532,6,556,0,556
עין מאהל,532,7,523,4,519
עין מאהל,532,8,490,3,487
עין מאהל,532,9,486,4,482
עין מאהל,532,10,499,2,497
עין מאהל,532,11,528,3,525
עין נקובא,521,1,372,6,366
עין נקובא,521,2,412,19,393
עין עירון,223,1,325,0,325
עין צורים,622,1,198,1,197
עין צורים,622,2,229,0,229
עין ראפה,514,1,367,6,361
עין שמר,139,1,232,0,232
עין שמר,139,2,206,0,206
עין שריד,880,1,394,3,391
עין שריד,880,2,391,4,387
עין תמר,1251,1,105,0,105
עינת,871,1,445,1,444
עכו,7600,2,416,7,409
עכו,7600,3,364,4,360
עכו,7600,5,314,2,312
עכו,7600,6,482,9,473
עכו,7600,7,435,4,431
עכו,7600,8,458,1,457
עכו,7600,9,384,5,379
עכו,7600,10,407,5,402
עכו,7600,11,316,4,312
עכו,7600,12,381,6,375
עכו,7600,13,304,11,293
עכו,7600,14,528,6,522
עכו,7600,15,465,1,464
עכו,7600,16,273,3,270
עכו,7600,17,378,2,376
עכו,7600,18,593,11,582
עכו,7600,19,336,10,326
עכו,7600,20,402,4,398
עכו,7600,21,394,12,382
עכו,7600,22,262,11,251
עכו,7600,23,432,8,424
עכו,7600,24,357,3,354
עכו,7600,25,382,4,378
עכו,7600,26,336,6,330
עכו,7600,27,321,4,317
עכו,7600,28,249,8,241
עכו,7600,29,272,1,271
עכו,7600,30,346,3,343
עכו,7600,31,454,4,450
עכו,7600,32,421,10,411
עכו,7600,33,464,7,457
עכו,7600,34,445,5,440
עכו,7600,35,535,5,530
עכו,7600,36,472,10,462
עכו,7600,37,303,14,289
עכו,7600,38,384,2,382
עכו,7600,39,407,3,404
עכו,7600,40,424,5,419
עכו,7600,41,388,8,380
עכו,7600,42,339,1,338
עכו,7600,43,325,2,323
עכו,7600,44,319,2,317
עכו,7600,45,328,2,326
עכו,7600,46,244,6,238
עכו,7600,47,422,10,412
עכו,7600,48,351,3,348
עכו,7600,50,247,5,242
עכו,7600,51,421,3,418
עכו,7600,52,382,6,376
עכו,7600,53,363,9,354
עכו,7600,54,284,10,274
עכו,7600,55,432,1,431
עכו,7600,56,240,3,237
עכו,7600,57,392,7,385
עכו,7600,58,466,6,460
עכו,7600,59,332,5,327
עכו,7600,60,303,17,286
עכו,7600,61,329,17,312
עכו,7600,62,377,1,376
עכו,7600,63,349,4,345
עכו,7600,64,581,4,577
עכו,7600,70,485,4,481
עכו,7600,71,622,6,616
עכו,7600,72,361,7,354
עכו,7600,73,438,6,432
עכו,7600,74,359,1,358
עכו,7600,75,415,7,408
עכו,7600,80,324,2,322
עלומים,1146,1,262,0,262
עלי זהב,3727,1,532,2,530
עלי,3765,1,463,3,460
עלי,3765,2,563,1,562
עלי,3765,3,503,0,503
עלמה,688,1,416,4,412
עלמון,3715,1,477,0,477
עלמון,3715,2,163,0,163
עמוקה,1212,1,105,1,104
עמינדב,779,1,477,1,476
עמיעד,385,1,269,0,269
עמיעוז,318,1,143,0,143
עמיקם,773,1,364,1,363
עמיר,319,1,348,0,348
עמנואל,3660,1,569,3,566
עמנואל,3660,2,375,6,369
עמנואל,3660,3,448,3,445
עמקה,708,1,360,8,352
ענב,3712,1,360,3,357
עספיא,534,1,347,3,344
עספיא,534,2,373,3,370
עספיא,534,3,367,5,362
עספיא,534,4,394,7,387
עספיא,534,5,310,0,310
עספיא,534,6,358,8,350
עספיא,534,7,344,4,340
עספיא,534,8,400,5,395
עספיא,534,9,375,6,369
עספיא,534,10,382,1,381
עספיא,534,11,333,9,324
עספיא,534,12,388,4,384
עפולה,7700,1,380,8,372
עפולה,7700,2,450,9,441
עפולה,7700,3,328,1,327
עפולה,7700,4,393,11,382
עפולה,7700,5,391,4,387
עפולה,7700,6,398,0,398
עפולה,7700,7,318,10,308
עפולה,7700,8,347,12,335
עפולה,7700,9,410,4,406
עפולה,7700,10,339,4,335
עפולה,7700,11,332,7,325
עפולה,7700,12,280,3,277
עפולה,7700,13,339,9,330
עפולה,7700,15,309,13,296
עפולה,7700,16,404,1,403
עפולה,7700,17,519,5,514
עפולה,7700,18,444,4,440
עפולה,7700,20,471,6,465
עפולה,7700,21,319,4,315
עפולה,7700,22,434,2,432
עפולה,7700,23,358,3,355
עפולה,7700,24,424,4,420
עפולה,7700,25,491,16,475
עפולה,7700,26,453,1,452
עפולה,7700,27,344,3,341
עפולה,7700,28,394,4,390
עפולה,7700,29,380,13,367
עפולה,7700,30,343,0,343
עפולה,7700,31,309,1,308
עפולה,7700,32,490,8,482
עפולה,7700,33,570,3,567
עפולה,7700,34,288,6,282
עפולה,7700,35,514,5,509
עפולה,7700,36,323,3,320
עפולה,7700,37,328,6,322
עפולה,7700,38,424,3,421
עפולה,7700,39,402,13,389
עפולה,7700,40,389,5,384
עפולה,7700,41,418,3,415
עפולה,7700,42,458,2,456
עפולה,7700,43,408,3,405
עפולה,7700,44,278,3,275
עפולה,7700,45,325,7,318
עפולה,7700,46,408,11,397
עפולה,7700,47,411,5,406
עפולה,7700,48,329,4,325
עפולה,7700,49,341,2,339
עפולה,7700,50,499,6,493
עפולה,7700,51,414,6,408
עפולה,7700,52,375,4,371
עפולה,7700,53,343,0,343
עפולה,7700,54,469,12,457
עפולה,7700,55,317,2,315
עפולה,7700,56,367,0,367
עפולה,7700,57,416,6,410
עפולה,7700,58,304,2,302
עפולה,7700,59,434,1,433
עפולה,7700,60,491,4,487
עפולה,7700,950,36,1,35
עפולה,7700,952,538,2,536
עץ אפרים,3778,1,454,0,454
עץ אפרים,3778,2,353,4,349
עצמון שגב,917,1,299,0,299
עצמון שגב,917,2,318,1,317
עראבה,531,1,446,0,446
עראבה,531,2,490,0,490
עראבה,531,3,476,2,474
עראבה,531,4,485,4,481
עראבה,531,5,497,1,496
עראבה,531,6,541,3,538
עראבה,531,7,478,2,476
עראבה,531,8,576,1,575
עראבה,531,9,500,7,493
עראבה,531,10,468,1,467
עראבה,531,11,444,3,441
עראבה,531,12,499,1,498
עראבה,531,13,502,3,499
עראבה,531,14,514,7,507
עראבה,531,15,480,2,478
עראבה,531,16,513,0,513
עראבה,531,17,465,2,463
עראבה,531,18,520,0,520
עראבה,531,19,461,2,459
עראבה,531,20,497,0,497
עראבה,531,21,487,0,487
עראמשה,1246,1,243,2,241
עראמשה,1246,2,194,1,193
ערב אל נעים,1335,1,238,7,231
ערד,2560,1,405,4,401
ערד,2560,2,340,8,332
ערד,2560,3,362,3,359
ערד,2560,4,360,12,348
ערד,2560,5,275,20,255
ערד,2560,6,198,7,191
ערד,2560,7,227,7,220
ערד,2560,8,313,5,308
ערד,2560,9,355,7,348
ערד,2560,10,330,4,326
ערד,2560,11,253,2,251
ערד,2560,12,549,7,542
ערד,2560,13,340,6,334
ערד,2560,14,416,4,412
ערד,2560,15,296,3,293
ערד,2560,16,280,10,270
ערד,2560,17,366,11,355
ערד,2560,18,348,10,338
ערד,2560,19,431,9,422
ערד,2560,20,306,8,298
ערד,2560,21,520,0,520
ערד,2560,22,465,4,461
ערד,2560,23,409,2,407
ערד,2560,24,428,6,422
ערד,2560,25,367,13,354
ערד,2560,26,444,9,435
ערד,2560,27,502,15,487
ערד,2560,28,435,4,431
ערד,2560,29,343,9,334
ערד,2560,30,437,11,426
ערד,2560,31,288,22,266
ערד,2560,32,382,10,372
ערד,2560,33,453,2,451
ערד,2560,35,329,1,328
ערוגות,593,1,514,2,512
ערערה,637,1,542,4,538
ערערה,637,2,475,0,475
ערערה,637,3,449,4,445
ערערה,637,4,444,7,437
ערערה,637,5,531,2,529
ערערה,637,6,414,1,413
ערערה,637,7,511,4,507
ערערה,637,8,568,2,566
ערערה,637,9,544,2,542
ערערה,637,10,402,0,402
ערערה,637,11,478,2,476
ערערה,637,12,449,6,443
ערערה,637,13,448,0,448
ערערה,637,14,369,3,366
ערערה,637,15,462,3,459
ערערה,637,16,522,3,519
ערערה,637,17,389,1,388
ערערה-בנגב,1192,1,423,4,419
ערערה-בנגב,1192,2,279,10,269
ערערה-בנגב,1192,3,308,6,302
ערערה-בנגב,1192,4,438,6,432
ערערה-בנגב,1192,5,199,2,197
ערערה-בנגב,1192,6,393,2,391
ערערה-בנגב,1192,7,652,21,631
ערערה-בנגב,1192,8,440,13,427
ערערה-בנגב,1192,9,297,3,294
ערערה-בנגב,1192,10,344,5,339
עשרת,591,1,331,0,331
עשרת,591,2,310,0,310
עתלית,53,1,364,3,361
עתלית,53,2,409,4,405
עתלית,53,3,463,1,462
עתלית,53,4,500,1,499
עתלית,53,5,390,1,389
עתלית,53,6,436,0,436
עתלית,53,7,382,4,378
עתלית,53,8,385,3,382
עתניאל,3748,1,335,0,335
פארן,1151,1,271,1,270
פדואל,3768,1,686,2,684
פדויים,750,1,215,1,214
פדיה,838,1,434,8,426
פוריה - כפר עבודה,1104,1,185,0,185
פוריה - נווה עובד,1105,1,283,3,280
פוריה - נווה עובד,1105,2,337,3,334
פוריה עילית,1313,1,458,5,453
פוריידיס,537,1,554,0,554
פוריידיס,537,2,371,8,363
פוריידיס,537,3,511,0,511
פוריידיס,537,4,343,4,339
פוריידיס,537,5,385,0,385
פוריידיס,537,6,406,0,406
פוריידיס,537,7,542,4,538
פוריידיס,537,8,516,0,516
פוריידיס,537,9,338,6,332
פוריידיס,537,10,402,2,400
פוריידיס,537,11,361,0,361
פוריידיס,537,12,387,4,383
פורת,767,1,267,3,264
פורת,767,2,302,3,299
פטיש,749,1,487,3,484
פלמחים,597,1,423,3,420
פני חבר,3723,1,166,0,166
פסגות,3659,1,402,0,402
פסגות,3659,2,426,3,423
פסוטה,535,1,347,5,342
פסוטה,535,2,347,6,341
פסוטה,535,3,373,1,372
פסוטה,535,4,291,3,288
"פעמי תש""ז",2059,1,267,3,264
פצאל,3615,1,176,0,176
פקיעין (בוקייעה),536,1,450,3,447
פקיעין (בוקייעה),536,2,473,4,469
פקיעין (בוקייעה),536,3,493,2,491
פקיעין (בוקייעה),536,4,304,2,302
פקיעין (בוקייעה),536,5,449,3,446
פקיעין (בוקייעה),536,6,447,1,446
פקיעין חדשה,281,1,207,0,207
פרדס חנה-כרכור,7800,1,310,7,303
פרדס חנה-כרכור,7800,2,506,2,504
פרדס חנה-כרכור,7800,3,469,0,469
פרדס חנה-כרכור,7800,4,282,6,276
פרדס חנה-כרכור,7800,5,526,2,524
פרדס חנה-כרכור,7800,6,323,4,319
פרדס חנה-כרכור,7800,7,535,3,532
פרדס חנה-כרכור,7800,8,551,2,549
פרדס חנה-כרכור,7800,9,466,4,462
פרדס חנה-כרכור,7800,10,487,4,483
פרדס חנה-כרכור,7800,11,391,3,388
פרדס חנה-כרכור,7800,12,460,4,456
פרדס חנה-כרכור,7800,13,534,6,528
פרדס חנה-כרכור,7800,14,302,6,296
פרדס חנה-כרכור,7800,15,331,9,322
פרדס חנה-כרכור,7800,16,470,4,466
פרדס חנה-כרכור,7800,17,458,10,448
פרדס חנה-כרכור,7800,18,243,12,231
פרדס חנה-כרכור,7800,19,365,1,364
פרדס חנה-כרכור,7800,20,604,1,603
פרדס חנה-כרכור,7800,21,478,6,472
פרדס חנה-כרכור,7800,22,342,3,339
פרדס חנה-כרכור,7800,23,291,4,287
פרדס חנה-כרכור,7800,24,378,4,374
פרדס חנה-כרכור,7800,25,479,1,478
פרדס חנה-כרכור,7800,26,562,0,562
פרדס חנה-כרכור,7800,27,577,2,575
פרדס חנה-כרכור,7800,28,435,1,434
פרדס חנה-כרכור,7800,29,526,4,522
פרדס חנה-כרכור,7800,30,392,1,391
פרדס חנה-כרכור,7800,31,473,20,453
פרדס חנה-כרכור,7800,32,397,6,391
פרדס חנה-כרכור,7800,33,428,4,424
פרדס חנה-כרכור,7800,34,383,2,381
פרדס חנה-כרכור,7800,35,355,5,350
פרדס חנה-כרכור,7800,36,419,5,414
פרדס חנה-כרכור,7800,37,373,0,373
פרדס חנה-כרכור,7800,38,261,8,253
פרדס חנה-כרכור,7800,39,266,2,264
פרדס חנה-כרכור,7800,40,272,2,270
פרדס חנה-כרכור,7800,41,390,5,385
פרדס חנה-כרכור,7800,42,350,0,350
פרדס חנה-כרכור,7800,43,219,6,213
פרדס חנה-כרכור,7800,44,665,1,664
פרדס חנה-כרכור,7800,45,327,1,326
פרדס חנה-כרכור,7800,46,436,2,434
פרדסיה,171,1,468,6,462
פרדסיה,171,2,562,3,559
פרדסיה,171,3,564,2,562
פרדסיה,171,4,504,2,502
פרדסיה,171,5,528,1,527
פרדסיה,171,6,536,1,535
פרדסיה,171,7,531,1,530
פרוד,599,1,239,1,238
פרזון,2053,1,228,1,227
פרי גן,1231,1,114,0,114
פתח תקווה,7900,1,469,8,461
פתח תקווה,7900,2,332,13,319
פתח תקווה,7900,3,558,1,557
פתח תקווה,7900,4,286,4,282
פתח תקווה,7900,5,365,3,362
פתח תקווה,7900,6,377,2,375
פתח תקווה,7900,7,252,2,250
פתח תקווה,7900,8,319,2,317
פתח תקווה,7900,9,246,3,243
פתח תקווה,7900,10,430,5,425
פתח תקווה,7900,11,328,4,324
פתח תקווה,7900,12,429,11,418
פתח תקווה,7900,13,347,7,340
פתח תקווה,7900,14,199,7,192
פתח תקווה,7900,15,220,5,215
פתח תקווה,7900,16,211,8,203
פתח תקווה,7900,17,268,9,259
פתח תקווה,7900,18,288,8,280
פתח תקווה,7900,19,340,4,336
פתח תקווה,7900,20,409,8,401
פתח תקווה,7900,21,357,4,353
פתח תקווה,7900,22,391,1,390
פתח תקווה,7900,23,377,7,370
פתח תקווה,7900,24,420,6,414
פתח תקווה,7900,25,411,5,406
פתח תקווה,7900,26,389,6,383
פתח תקווה,7900,27,377,3,374
פתח תקווה,7900,28,499,5,494
פתח תקווה,7900,29,361,6,355
פתח תקווה,7900,30,437,5,432
פתח תקווה,7900,31,479,6,473
פתח תקווה,7900,32,490,7,483
פתח תקווה,7900,33,397,10,387
פתח תקווה,7900,34,395,1,394
פתח תקווה,7900,35,446,6,440
פתח תקווה,7900,36,440,2,438
פתח תקווה,7900,37,358,5,353
פתח תקווה,7900,38,340,5,335
פתח תקווה,7900,39,352,2,350
פתח תקווה,7900,40,433,10,423
פתח תקווה,7900,41,560,3,557
פתח תקווה,7900,42,568,1,567
פתח תקווה,7900,43,407,2,405
פתח תקווה,7900,44,387,3,384
פתח תקווה,7900,45,288,6,282
פתח תקווה,7900,46,397,6,391
פתח תקווה,7900,47,288,4,284
פתח תקווה,7900,48,299,5,294
פתח תקווה,7900,49,659,2,657
פתח תקווה,7900,50,507,11,496
פתח תקווה,7900,51,404,7,397
פתח תקווה,7900,52,422,4,418
פתח תקווה,7900,53,476,8,468
פתח תקווה,7900,54,523,5,518
פתח תקווה,7900,55,542,1,541
פתח תקווה,7900,56,431,1,430
פתח תקווה,7900,57,386,5,381
פתח תקווה,7900,58,452,5,447
פתח תקווה,7900,59,384,3,381
פתח תקווה,7900,60,496,7,489
פתח תקווה,7900,61,285,8,277
פתח תקווה,7900,62,471,4,467
פתח תקווה,7900,63,395,7,388
פתח תקווה,7900,64,403,3,400
פתח תקווה,7900,65,257,4,253
פתח תקווה,7900,66,396,6,390
פתח תקווה,7900,67,530,10,520
פתח תקווה,7900,68,408,7,401
פתח תקווה,7900,69,556,0,556
פתח תקווה,7900,70,381,8,373
פתח תקווה,7900,71,500,4,496
פתח תקווה,7900,72,282,3,279
פתח תקווה,7900,73,488,9,479
פתח תקווה,7900,74,400,3,397
פתח תקווה,7900,75,485,5,480
פתח תקווה,7900,76,432,7,425
פתח תקווה,7900,77,519,2,517
פתח תקווה,7900,78,384,6,378
פתח תקווה,7900,79,427,13,414
פתח תקווה,7900,80,398,3,395
פתח תקווה,7900,81,442,4,438
פתח תקווה,7900,82,463,3,460
פתח תקווה,7900,83,512,1,511
פתח תקווה,7900,84,337,3,334
פתח תקווה,7900,85,421,1,420
פתח תקווה,7900,86,434,4,430
פתח תקווה,7900,87,387,6,381
פתח תקווה,7900,88,463,0,463
פתח תקווה,7900,89,332,3,329
פתח תקווה,7900,90,231,0,231
פתח תקווה,7900,91,332,7,325
פתח תקווה,7900,92,446,6,440
פתח תקווה,7900,93,415,7,408
פתח תקווה,7900,94,417,5,412
פתח תקווה,7900,95,418,2,416
פתח תקווה,7900,96,373,6,367
פתח תקווה,7900,97,438,2,436
פתח תקווה,7900,98,350,4,346
פתח תקווה,7900,99,495,6,489
פתח תקווה,7900,100,308,4,304
פתח תקווה,7900,101,404,1,403
פתח תקווה,7900,102,623,1,622
פתח תקווה,7900,103,419,2,417
פתח תקווה,7900,104,438,6,432
פתח תקווה,7900,105,488,8,480
פתח תקווה,7900,106,397,6,391
פתח תקווה,7900,107,436,4,432
פתח תקווה,7900,108,356,1,355
פתח תקווה,7900,109,557,6,551
פתח תקווה,7900,110,529,1,528
פתח תקווה,7900,111,337,3,334
פתח תקווה,7900,112,380,3,377
פתח תקווה,7900,113,533,10,523
פתח תקווה,7900,114,245,6,239
פתח תקווה,7900,115,474,5,469
פתח תקווה,7900,116,379,2,377
פתח תקווה,7900,117,451,10,441
פתח תקווה,7900,118,397,0,397
פתח תקווה,7900,119,359,1,358
פתח תקווה,7900,120,417,1,416
פתח תקווה,7900,121,342,0,342
פתח תקווה,7900,122,359,2,357
פתח תקווה,7900,123,495,1,494
פתח תקווה,7900,125,507,7,500
פתח תקווה,7900,126,509,1,508
פתח תקווה,7900,127,375,15,360
פתח תקווה,7900,128,412,2,410
פתח תקווה,7900,129,461,3,458
פתח תקווה,7900,130,495,1,494
פתח תקווה,7900,131,433,3,430
פתח תקווה,7900,132,441,5,436
פתח תקווה,7900,133,242,6,236
פתח תקווה,7900,134,298,9,289
פתח תקווה,7900,135,447,9,438
פתח תקווה,7900,136,288,4,284
פתח תקווה,7900,137,336,8,328
פתח תקווה,7900,138,487,0,487
פתח תקווה,7900,139,314,2,312
פתח תקווה,7900,140,476,0,476
פתח תקווה,7900,141,374,1,373
פתח תקווה,7900,142,241,1,240
פתח תקווה,7900,143,559,4,555
פתח תקווה,7900,144,440,3,437
פתח תקווה,7900,145,412,2,410
פתח תקווה,7900,146,514,2,512
פתח תקווה,7900,147,471,4,467
פתח תקווה,7900,148,306,4,302
פתח תקווה,7900,149,361,4,357
פתח תקווה,7900,150,363,3,360
פתח תקווה,7900,151,501,7,494
פתח תקווה,7900,152,352,12,340
פתח תקווה,7900,153,506,2,504
פתח תקווה,7900,154,389,3,386
פתח תקווה,7900,155,356,7,349
פתח תקווה,7900,156,376,3,373
פתח תקווה,7900,157,337,4,333
פתח תקווה,7900,158,465,11,454
פתח תקווה,7900,159,475,8,467
פתח תקווה,7900,160,372,4,368
פתח תקווה,7900,161,502,5,497
פתח תקווה,7900,162,318,7,311
פתח תקווה,7900,163,494,3,491
פתח תקווה,7900,164,319,1,318
פתח תקווה,7900,165,516,10,506
פתח תקווה,7900,166,469,4,465
פתח תקווה,7900,167,394,9,385
פתח תקווה,7900,168,406,14,392
פתח תקווה,7900,169,323,4,319
פתח תקווה,7900,170,466,6,460
פתח תקווה,7900,171,426,2,424
פתח תקווה,7900,172,380,7,373
פתח תקווה,7900,173,505,5,500
פתח תקווה,7900,174,501,4,497
פתח תקווה,7900,175,260,5,255
פתח תקווה,7900,176,434,3,431
פתח תקווה,7900,177,334,3,331
פתח תקווה,7900,179,504,6,498
פתח תקווה,7900,185,512,3,509
פתח תקווה,7900,186,486,6,480
פתח תקווה,7900,187,510,2,508
פתח תקווה,7900,188,383,8,375
פתח תקווה,7900,189,396,5,391
פתח תקווה,7900,191,334,4,330
פתח תקווה,7900,192,323,5,318
פתח תקווה,7900,193,319,8,311
פתח תקווה,7900,194,354,1,353
פתח תקווה,7900,195,452,2,450
פתח תקווה,7900,196,420,12,408
פתח תקווה,7900,197,520,4,516
פתח תקווה,7900,198,613,8,605
פתח תקווה,7900,199,422,5,417
פתח תקווה,7900,200,603,4,599
פתח תקווה,7900,201,484,0,484
פתח תקווה,7900,202,422,0,422
פתח תקווה,7900,203,617,1,616
פתח תקווה,7900,204,526,1,525
פתח תקווה,7900,205,293,6,287
פתח תקווה,7900,206,385,6,379
פתח תקווה,7900,207,609,3,606
פתח תקווה,7900,208,440,3,437
פתח תקווה,7900,209,493,2,491
פתח תקווה,7900,210,492,0,492
פתח תקווה,7900,211,478,1,477
פתח תקווה,7900,212,416,4,412
פתח תקווה,7900,213,480,3,477
פתח תקווה,7900,214,286,11,275
פתח תקווה,7900,215,348,8,340
פתח תקווה,7900,216,244,10,234
פתח תקווה,7900,217,455,9,446
פתח תקווה,7900,218,399,4,395
פתח תקווה,7900,219,295,4,291
פתח תקווה,7900,220,545,2,543
פתח תקווה,7900,221,478,7,471
פתח תקווה,7900,222,389,4,385
פתח תקווה,7900,223,352,12,340
פתח תקווה,7900,225,261,4,257
פתח תקווה,7900,226,355,3,352
פתח תקווה,7900,227,392,2,390
פתח תקווה,7900,228,418,2,416
פתח תקווה,7900,229,416,6,410
פתח תקווה,7900,230,513,3,510
פתח תקווה,7900,231,472,0,472
פתח תקווה,7900,232,440,0,440
פתח תקווה,7900,233,400,5,395
פתח תקווה,7900,234,551,0,551
פתח תקווה,7900,235,528,11,517
פתח תקווה,7900,236,485,3,482
פתח תקווה,7900,237,615,4,611
פתח תקווה,7900,238,470,2,468
פתח תקווה,7900,239,508,1,507
פתח תקווה,7900,240,274,3,271
פתח תקווה,7900,241,504,1,503
פתח תקווה,7900,242,327,2,325
פתח תקווה,7900,243,375,1,374
פתח תקווה,7900,244,567,2,565
פתח תקווה,7900,245,530,3,527
פתח תקווה,7900,246,675,2,673
פתח תקווה,7900,247,542,1,541
פתח תקווה,7900,248,410,0,410
פתח תקווה,7900,249,652,3,649
פתח תקווה,7900,251,584,1,583
פתח תקווה,7900,253,276,4,272
פתח תקווה,7900,254,335,5,330
פתח תקווה,7900,255,350,8,342
פתח תקווה,7900,256,294,5,289
פתח תקווה,7900,257,589,10,579
פתח תקווה,7900,258,439,2,437
פתח תקווה,7900,259,575,0,575
פתח תקווה,7900,260,363,0,363
פתח תקווה,7900,261,459,3,456
פתח תקווה,7900,262,621,8,613
פתח תקווה,7900,263,396,2,394
פתח תקווה,7900,264,370,1,369
פתח תקווה,7900,265,338,3,335
פתח תקווה,7900,266,347,3,344
פתח תקווה,7900,267,544,5,539
פתח תקווה,7900,268,493,1,492
פתח תקווה,7900,269,594,0,594
פתח תקווה,7900,270,331,4,327
פתח תקווה,7900,271,615,2,613
פתח תקווה,7900,272,596,0,596
פתח תקווה,7900,273,503,5,498
פתח תקווה,7900,274,567,0,567
פתח תקווה,7900,275,527,4,523
פתח תקווה,7900,276,492,2,490
פתח תקווה,7900,277,641,4,637
פתח תקווה,7900,278,560,2,558
פתח תקווה,7900,279,364,5,359
פתח תקווה,7900,280,513,3,510
פתח תקווה,7900,281,445,2,443
פתח תקווה,7900,282,593,1,592
פתח תקווה,7900,283,411,3,408
פתח תקווה,7900,284,451,0,451
פתח תקווה,7900,285,544,8,536
פתח תקווה,7900,286,601,2,599
פתח תקווה,7900,287,506,0,506
פתח תקווה,7900,288,533,2,531
פתח תקווה,7900,289,516,2,514
פתח תקווה,7900,290,583,6,577
פתח תקווה,7900,291,374,6,368
פתח תקווה,7900,292,492,2,490
פתח תקווה,7900,293,356,4,352
פתח תקווה,7900,294,560,1,559
פתח תקווה,7900,950,243,7,236
פתח תקווה,7900,953,86,0,86
פתח תקווה,7900,954,452,1,451
פתח תקווה,7900,955,660,0,660
פתח תקווה,7900,956,598,0,598
פתח תקווה,7900,957,498,4,494
פתח תקווה,7900,958,481,1,480
פתח תקווה,7900,959,380,0,380
פתח תקווה,7900,960,605,2,603
פתח תקווה,7900,962,570,2,568
פתחיה,839,1,495,1,494
צאלים,413,1,284,0,284
צביה,1180,1,179,0,179
צובה,465,1,435,2,433
צוחר,1136,1,271,2,269
צופים,3791,1,453,2,451
צופים,3791,2,475,3,472
צופית,198,1,289,0,289
צופית,198,2,311,0,311
צופר,1150,1,248,1,247
צוקי ים,1102,1,124,0,124
צוקים,1262,1,107,3,104
צור הדסה,1113,1,496,1,495
צור הדסה,1113,2,512,2,510
צור הדסה,1113,3,611,1,610
צור הדסה,1113,4,529,1,528
צור הדסה,1113,5,338,0,338
צור הדסה,1113,6,484,2,482
צור יצחק,1345,1,602,1,601
צור יצחק,1345,2,631,2,629
צור יצחק,1345,3,612,2,610
צור משה,276,1,511,1,510
צור משה,276,2,411,1,410
צור משה,276,3,416,0,416
צור נתן,1148,1,171,2,169
צוריאל,774,1,199,0,199
צורית,1221,1,464,1,463
ציפורי,613,1,458,3,455
צלפון,796,1,439,9,430
צנדלה,636,1,335,0,335
צנדלה,636,2,410,1,409
צפריה,594,1,395,3,392
צפרירים,1079,1,205,1,204
צפת,8000,1,337,1,336
צפת,8000,2,335,6,329
צפת,8000,3,467,4,463
צפת,8000,4,305,1,304
צפת,8000,5,361,5,356
צפת,8000,6,345,7,338
צפת,8000,7,523,16,507
צפת,8000,8,312,2,310
צפת,8000,9,329,3,326
צפת,8000,10,254,1,253
צפת,8000,11,511,5,506
צפת,8000,12,382,6,376
צפת,8000,13,415,5,410
צפת,8000,14,330,1,329
צפת,8000,15,469,5,464
צפת,8000,16,346,5,341
צפת,8000,17,466,4,462
צפת,8000,18,274,4,270
צפת,8000,19,509,10,499
צפת,8000,20,396,19,377
צפת,8000,21,351,11,340
צפת,8000,22,317,1,316
צפת,8000,23,332,3,329
צפת,8000,24,454,1,453
צפת,8000,25,371,1,370
צפת,8000,26,326,3,323
צפת,8000,27,349,1,348
צפת,8000,28,416,12,404
צפת,8000,29,410,6,404
צפת,8000,30,335,4,331
צפת,8000,31,360,4,356
צפת,8000,32,354,3,351
צפת,8000,40,195,8,187
צפת,8000,41,495,5,490
צפת,8000,42,453,4,449
צפת,8000,43,481,1,480
צפת,8000,44,299,1,298
צפת,8000,45,314,8,306
צרופה,612,1,523,2,521
צרעה,567,1,275,0,275
צרעה,567,2,264,0,264
קבועה (שבט),1234,1,206,3,203
קבוצת יבנה,334,1,222,0,222
קבוצת יבנה,334,2,254,0,254
קדומים,3557,1,498,4,494
קדומים,3557,2,538,3,535
קדומים,3557,3,567,1,566
קדומים,3557,4,450,0,450
קדימה-צורן,195,1,534,0,534
קדימה-צורן,195,2,499,6,493
קדימה-צורן,195,3,596,4,592
קדימה-צורן,195,4,548,2,546
קדימה-צורן,195,5,501,10,491
קדימה-צורן,195,6,606,1,605
קדימה-צורן,195,7,539,2,537
קדימה-צורן,195,8,440,2,438
קדימה-צורן,195,9,552,2,550
קדימה-צורן,195,10,516,0,516
קדימה-צורן,195,11,542,4,538
קדימה-צורן,195,12,569,4,565
קדימה-צורן,195,101,444,2,442
קדימה-צורן,195,102,487,3,484
קדימה-צורן,195,103,531,6,525
קדימה-צורן,195,104,583,2,581
קדימה-צורן,195,105,576,4,572
קדימה-צורן,195,106,213,1,212
קדימה-צורן,195,107,446,1,445
קדימה-צורן,195,108,607,0,607
קדמת צבי,4025,1,222,1,221
קדר,3781,1,428,3,425
קדר,3781,2,232,1,231
קדרון,615,1,448,0,448
קדרון,615,2,419,1,418
קדרים,1211,1,87,0,87
קודייראת א-צאנע(ש,964,1,83,4,79
קודייראת א-צאנע(ש,964,2,303,0,303
קוואעין (שבט),972,1,309,0,309
קוממיות,766,1,135,1,134
קורנית,1179,1,444,0,444
קטורה,1052,1,225,0,225
קיסריה,1167,1,402,0,402
קיסריה,1167,2,380,0,380
קיסריה,1167,3,308,5,303
קיסריה,1167,4,436,1,435
קיסריה,1167,5,539,2,537
קיסריה,1167,6,384,0,384
קיסריה,1167,7,410,3,407
קלחים,414,1,250,1,249
קליה,3601,1,255,1,254
קלנסווה,638,1,386,3,383
קלנסווה,638,2,470,5,465
קלנסווה,638,3,509,7,502
קלנסווה,638,4,474,2,472
קלנסווה,638,5,432,2,430
קלנסווה,638,6,446,4,442
קלנסווה,638,7,440,4,436
קלנסווה,638,8,482,0,482
קלנסווה,638,9,488,2,486
קלנסווה,638,10,470,3,467
קלנסווה,638,11,518,0,518
קלנסווה,638,12,475,1,474
קלנסווה,638,13,467,6,461
קלנסווה,638,14,547,4,543
קלנסווה,638,15,520,2,518
קלנסווה,638,16,460,3,457
קלנסווה,638,17,577,5,572
קלנסווה,638,18,449,1,448
קלע,4024,1,95,2,93
קציר,1243,1,477,2,475
קציר,1243,2,187,0,187
קציר,1243,3,383,6,377
קציר,1243,4,339,3,336
קצר א-סר,1347,1,355,2,353
קצרין,4100,1,412,5,407
קצרין,4100,2,392,7,385
קצרין,4100,3,331,1,330
קצרין,4100,4,399,3,396
קצרין,4100,5,438,4,434
קצרין,4100,6,391,7,384
קצרין,4100,7,333,11,322
קצרין,4100,8,350,6,344
קצרין,4100,9,510,4,506
קרית אונו,2620,1,437,4,433
קרית אונו,2620,2,513,5,508
קרית אונו,2620,3,437,3,434
קרית אונו,2620,4,550,4,546
קרית אונו,2620,5,458,2,456
קרית אונו,2620,6,459,2,457
קרית אונו,2620,7,416,5,411
קרית אונו,2620,8,592,1,591
קרית אונו,2620,9,422,2,420
קרית אונו,2620,10,445,9,436
קרית אונו,2620,11,444,2,442
קרית אונו,2620,12,508,4,504
קרית אונו,2620,13,411,3,408
קרית אונו,2620,14,577,3,574
קרית אונו,2620,15,505,5,500
קרית אונו,2620,16,433,1,432
קרית אונו,2620,17,432,9,423
קרית אונו,2620,18,364,1,363
קרית אונו,2620,19,390,13,377
קרית אונו,2620,20,436,1,435
קרית אונו,2620,21,279,1,278
קרית אונו,2620,22,499,2,497
קרית אונו,2620,23,344,4,340
קרית אונו,2620,24,508,3,505
קרית אונו,2620,25,383,4,379
קרית אונו,2620,26,385,2,383
קרית אונו,2620,27,466,5,461
קרית אונו,2620,28,482,12,470
קרית אונו,2620,29,335,0,335
קרית אונו,2620,31,360,5,355
קרית אונו,2620,32,594,2,592
קרית אונו,2620,33,542,7,535
קרית אונו,2620,34,581,7,574
קרית אונו,2620,35,453,2,451
קרית אונו,2620,36,515,4,511
קרית אונו,2620,37,313,0,313
קרית אונו,2620,38,535,2,533
קרית אונו,2620,39,682,2,680
קרית אונו,2620,40,647,3,644
קרית אונו,2620,41,518,1,517
קרית אונו,2620,950,641,3,638
קרית אונו,2620,951,667,2,665
קרית אונו,2620,952,650,2,648
קרית ארבע,3611,1,590,1,589
קרית ארבע,3611,2,373,2,371
קרית ארבע,3611,3,456,5,451
קרית ארבע,3611,4,580,4,576
קרית ארבע,3611,5,454,1,453
קרית ארבע,3611,6,320,1,319
קרית ארבע,3611,7,567,7,560
קרית אתא,6800,1,299,10,289
קרית אתא,6800,3,258,10,248
קרית אתא,6800,4,247,4,243
קרית אתא,6800,5,311,7,304
קרית אתא,6800,6,265,1,264
קרית אתא,6800,7,254,3,251
קרית אתא,6800,8,433,4,429
קרית אתא,6800,9,345,2,343
קרית אתא,6800,10,323,7,316
קרית אתא,6800,11,574,1,573
קרית אתא,6800,12,285,2,283
קרית אתא,6800,13,441,6,435
קרית אתא,6800,14,340,5,335
קרית אתא,6800,15,470,5,465
קרית אתא,6800,16,401,4,397
קרית אתא,6800,17,389,2,387
קרית אתא,6800,18,356,10,346
קרית אתא,6800,19,261,5,256
קרית אתא,6800,20,368,14,354
קרית אתא,6800,21,319,4,315
קרית אתא,6800,22,407,10,397
קרית אתא,6800,23,487,7,480
קרית אתא,6800,24,429,5,424
קרית אתא,6800,25,444,4,440
קרית אתא,6800,26,349,7,342
קרית אתא,6800,27,343,11,332
קרית אתא,6800,28,563,12,551
קרית אתא,6800,29,481,4,477
קרית אתא,6800,30,482,5,477
קרית אתא,6800,31,367,2,365
קרית אתא,6800,32,364,8,356
קרית אתא,6800,33,482,5,477
קרית אתא,6800,34,553,7,546
קרית אתא,6800,35,379,9,370
קרית אתא,6800,36,533,6,527
קרית אתא,6800,37,495,5,490
קרית אתא,6800,38,319,6,313
קרית אתא,6800,39,518,5,513
קרית אתא,6800,40,287,11,276
קרית אתא,6800,41,289,6,283
קרית אתא,6800,42,363,7,356
קרית אתא,6800,43,483,3,480
קרית אתא,6800,44,335,1,334
קרית אתא,6800,45,444,0,444
קרית אתא,6800,46,437,5,432
קרית אתא,6800,47,465,5,460
קרית אתא,6800,48,407,2,405
קרית אתא,6800,50,353,5,348
קרית אתא,6800,51,327,9,318
קרית אתא,6800,52,390,3,387
קרית אתא,6800,53,438,3,435
קרית אתא,6800,54,528,3,525
קרית אתא,6800,55,551,3,548
קרית אתא,6800,56,453,4,449
קרית אתא,6800,57,500,6,494
קרית אתא,6800,58,369,1,368
קרית אתא,6800,59,508,9,499
קרית אתא,6800,60,362,3,359
קרית אתא,6800,61,529,3,526
קרית אתא,6800,62,388,1,387
קרית אתא,6800,63,418,2,416
קרית אתא,6800,64,430,4,426
קרית אתא,6800,65,466,2,464
קרית אתא,6800,66,548,3,545
קרית אתא,6800,67,592,3,589
קרית אתא,6800,68,503,1,502
קרית אתא,6800,69,390,2,388
קרית אתא,6800,70,366,3,363
קרית אתא,6800,71,472,3,469
קרית אתא,6800,72,295,2,293
קרית אתא,6800,73,508,2,506
קרית אתא,6800,74,377,4,373
קרית אתא,6800,75,472,10,462
קרית ביאליק,9500,1,309,4,305
קרית ביאליק,9500,2,475,2,473
קרית ביאליק,9500,3,360,5,355
קרית ביאליק,9500,4,493,8,485
קרית ביאליק,9500,5,341,1,340
קרית ביאליק,9500,6,382,6,376
קרית ביאליק,9500,7,367,2,365
קרית ביאליק,9500,8,289,1,288
קרית ביאליק,9500,9,420,5,415
קרית ביאליק,9500,10,526,9,517
קרית ביאליק,9500,11,455,7,448
קרית ביאליק,9500,12,371,8,363
קרית ביאליק,9500,13,364,2,362
קרית ביאליק,9500,14,370,9,361
קרית ביאליק,9500,15,481,3,478
קרית ביאליק,9500,16,341,7,334
קרית ביאליק,9500,17,343,3,340
קרית ביאליק,9500,18,415,2,413
קרית ביאליק,9500,19,421,6,415
קרית ביאליק,9500,20,383,6,377
קרית ביאליק,9500,21,350,9,341
קרית ביאליק,9500,22,292,11,281
קרית ביאליק,9500,23,341,10,331
קרית ביאליק,9500,24,267,10,257
קרית ביאליק,9500,25,377,8,369
קרית ביאליק,9500,26,326,3,323
קרית ביאליק,9500,27,335,7,328
קרית ביאליק,9500,28,350,8,342
קרית ביאליק,9500,29,395,3,392
קרית ביאליק,9500,30,545,5,540
קרית ביאליק,9500,31,373,1,372
קרית ביאליק,9500,32,273,2,271
קרית ביאליק,9500,33,481,4,477
קרית ביאליק,9500,34,430,3,427
קרית ביאליק,9500,35,405,3,402
קרית ביאליק,9500,36,291,0,291
קרית ביאליק,9500,37,402,1,401
קרית ביאליק,9500,38,451,4,447
קרית ביאליק,9500,39,330,1,329
קרית ביאליק,9500,40,509,4,505
קרית ביאליק,9500,41,543,5,538
קרית ביאליק,9500,42,401,3,398
קרית ביאליק,9500,43,363,5,358
קרית ביאליק,9500,44,337,1,336
קרית ביאליק,9500,45,488,0,488
קרית ביאליק,9500,46,502,3,499
קרית ביאליק,9500,47,458,2,456
קרית ביאליק,9500,48,302,1,301
קרית ביאליק,9500,49,373,5,368
קרית ביאליק,9500,50,265,6,259
קרית ביאליק,9500,51,494,0,494
קרית ביאליק,9500,52,406,1,405
קרית ביאליק,9500,53,326,2,324
קרית ביאליק,9500,54,317,2,315
קרית ביאליק,9500,55,324,2,322
קרית ביאליק,9500,951,459,2,457
קרית ביאליק,9500,952,666,3,663
קרית ביאליק,9500,953,509,1,508
קרית גת,2630,1,246,3,243
קרית גת,2630,2,395,3,392
קרית גת,2630,3,283,2,281
קרית גת,2630,4,344,15,329
קרית גת,2630,5,396,10,386
קרית גת,2630,6,376,5,371
קרית גת,2630,8,411,2,409
קרית גת,2630,9,429,1,428
קרית גת,2630,10,403,1,402
קרית גת,2630,11,367,3,364
קרית גת,2630,12,358,2,356
קרית גת,2630,13,428,9,419
קרית גת,2630,14,501,11,490
קרית גת,2630,15,376,11,365
קרית גת,2630,16,406,10,396
קרית גת,2630,17,369,3,366
קרית גת,2630,18,317,10,307
קרית גת,2630,19,343,16,327
קרית גת,2630,20,265,5,260
קרית גת,2630,21,290,3,287
קרית גת,2630,22,442,7,435
קרית גת,2630,23,326,4,322
קרית גת,2630,24,422,2,420
קרית גת,2630,26,416,7,409
קרית גת,2630,28,435,6,429
קרית גת,2630,29,304,6,298
קרית גת,2630,30,438,1,437
קרית גת,2630,31,426,11,415
קרית גת,2630,32,445,10,435
קרית גת,2630,33,383,6,377
קרית גת,2630,34,394,7,387
קרית גת,2630,35,365,3,362
קרית גת,2630,36,319,6,313
קרית גת,2630,37,382,3,379
קרית גת,2630,38,321,7,314
קרית גת,2630,39,356,1,355
קרית גת,2630,40,346,6,340
קרית גת,2630,41,383,11,372
קרית גת,2630,42,325,8,317
קרית גת,2630,43,374,2,372
קרית גת,2630,44,343,7,336
קרית גת,2630,45,453,2,451
קרית גת,2630,49,385,4,381
קרית גת,2630,50,341,7,334
קרית גת,2630,51,358,6,352
קרית גת,2630,52,420,4,416
קרית גת,2630,53,482,2,480
קרית גת,2630,54,308,4,304
קרית גת,2630,55,542,5,537
קרית גת,2630,56,496,2,494
קרית גת,2630,57,512,3,509
קרית גת,2630,58,494,11,483
קרית גת,2630,59,414,4,410
קרית גת,2630,60,421,10,411
קרית גת,2630,61,428,3,425
קרית גת,2630,62,470,4,466
קרית גת,2630,63,521,11,510
קרית גת,2630,64,364,8,356
קרית גת,2630,65,413,9,404
קרית גת,2630,66,509,4,505
קרית גת,2630,67,360,8,352
קרית גת,2630,68,416,1,415
קרית גת,2630,69,324,2,322
קרית גת,2630,70,309,4,305
קרית גת,2630,71,306,12,294
קרית גת,2630,72,505,0,505
קרית גת,2630,73,330,1,329
קרית גת,2630,74,731,0,731
קרית טבעון,2300,1,459,1,458
קרית טבעון,2300,2,468,2,466
קרית טבעון,2300,3,510,2,508
קרית טבעון,2300,4,322,1,321
קרית טבעון,2300,5,445,1,444
קרית טבעון,2300,6,458,2,456
קרית טבעון,2300,7,572,7,565
קרית טבעון,2300,8,446,3,443
קרית טבעון,2300,9,396,1,395
קרית טבעון,2300,10,279,10,269
קרית טבעון,2300,11,325,2,323
קרית טבעון,2300,12,548,2,546
קרית טבעון,2300,13,486,1,485
קרית טבעון,2300,14,527,2,525
קרית טבעון,2300,15,504,3,501
קרית טבעון,2300,16,434,4,430
קרית טבעון,2300,17,347,2,345
קרית טבעון,2300,19,234,3,231
קרית טבעון,2300,20,368,1,367
קרית טבעון,2300,21,461,2,459
קרית טבעון,2300,22,349,1,348
קרית טבעון,2300,23,307,1,306
קרית טבעון,2300,24,280,4,276
קרית ים,9600,1,388,4,384
קרית ים,9600,2,462,3,459
קרית ים,9600,3,383,6,377
קרית ים,9600,4,412,3,409
קרית ים,9600,5,308,4,304
קרית ים,9600,6,265,3,262
קרית ים,9600,7,255,0,255
קרית ים,9600,8,338,1,337
קרית ים,9600,9,315,2,313
קרית ים,9600,10,287,7,280
קרית ים,9600,11,312,3,309
קרית ים,9600,12,349,4,345
קרית ים,9600,13,276,8,268
קרית ים,9600,14,326,8,318
קרית ים,9600,15,348,12,336
קרית ים,9600,16,414,7,407
קרית ים,9600,17,307,5,302
קרית ים,9600,18,252,5,247
קרית ים,9600,19,307,4,303
קרית ים,9600,20,448,5,443
קרית ים,9600,21,273,18,255
קרית ים,9600,22,356,8,348
קרית ים,9600,23,469,2,467
קרית ים,9600,24,384,4,380
קרית ים,9600,25,473,1,472
קרית ים,9600,26,329,7,322
קרית ים,9600,27,253,13,240
קרית ים,9600,28,230,7,223
קרית ים,9600,29,360,4,356
קרית ים,9600,30,276,5,271
קרית ים,9600,31,258,15,243
קרית ים,9600,32,499,7,492
קרית ים,9600,33,431,8,423
קרית ים,9600,34,301,11,290
קרית ים,9600,35,282,8,274
קרית ים,9600,36,413,6,407
קרית ים,9600,37,302,6,296
קרית ים,9600,38,423,10,413
קרית ים,9600,39,341,6,335
קרית ים,9600,40,336,4,332
קרית ים,9600,41,409,6,403
קרית ים,9600,42,482,7,475
קרית ים,9600,43,491,6,485
קרית ים,9600,44,403,5,398
קרית ים,9600,45,295,14,281
קרית ים,9600,46,392,5,387
קרית ים,9600,47,287,3,284
קרית ים,9600,48,524,4,520
קרית ים,9600,49,405,5,400
קרית ים,9600,50,448,10,438
קרית ים,9600,51,349,2,347
קרית ים,9600,52,389,1,388
קרית ים,9600,53,504,12,492
קרית ים,9600,60,509,1,508
קרית ים,9600,61,362,5,357
קרית ים,9600,62,425,2,423
קרית ים,9600,63,515,3,512
קרית ים,9600,950,473,5,468
קרית יערים,1137,1,468,4,464
קרית יערים,1137,2,370,2,368
קרית יערים,1137,3,498,4,494
קרית יערים,1137,4,487,13,474
קרית מוצקין,8200,1,453,5,448
קרית מוצקין,8200,2,298,0,298
קרית מוצקין,8200,3,469,1,468
קרית מוצקין,8200,4,374,3,371
קרית מוצקין,8200,5,577,2,575
קרית מוצקין,8200,6,406,3,403
קרית מוצקין,8200,7,378,12,366
קרית מוצקין,8200,8,244,2,242
קרית מוצקין,8200,9,446,4,442
קרית מוצקין,8200,10,449,1,448
קרית מוצקין,8200,11,344,1,343
קרית מוצקין,8200,12,390,6,384
קרית מוצקין,8200,13,292,5,287
קרית מוצקין,8200,14,414,7,407
קרית מוצקין,8200,15,311,3,308
קרית מוצקין,8200,16,272,5,267
קרית מוצקין,8200,17,400,7,393
קרית מוצקין,8200,18,436,1,435
קרית מוצקין,8200,19,482,10,472
קרית מוצקין,8200,20,412,3,409
קרית מוצקין,8200,21,440,13,427
קרית מוצקין,8200,22,324,3,321
קרית מוצקין,8200,23,512,12,500
קרית מוצקין,8200,24,422,1,421
קרית מוצקין,8200,25,414,8,406
קרית מוצקין,8200,26,433,4,429
קרית מוצקין,8200,27,315,3,312
קרית מוצקין,8200,28,349,12,337
קרית מוצקין,8200,29,373,6,367
קרית מוצקין,8200,30,314,2,312
קרית מוצקין,8200,31,432,2,430
קרית מוצקין,8200,32,317,2,315
קרית מוצקין,8200,33,496,3,493
קרית מוצקין,8200,34,327,3,324
קרית מוצקין,8200,35,356,2,354
קרית מוצקין,8200,36,278,7,271
קרית מוצקין,8200,37,363,4,359
קרית מוצקין,8200,38,397,6,391
קרית מוצקין,8200,39,431,6,425
קרית מוצקין,8200,40,559,11,548
קרית מוצקין,8200,43,383,5,378
קרית מוצקין,8200,44,401,3,398
קרית מוצקין,8200,50,511,3,508
קרית מוצקין,8200,51,429,5,424
קרית מוצקין,8200,52,361,2,359
קרית מוצקין,8200,53,467,3,464
קרית מוצקין,8200,55,498,2,496
קרית מוצקין,8200,60,626,6,620
קרית מוצקין,8200,61,524,3,521
קרית מוצקין,8200,62,515,3,512
קרית מוצקין,8200,63,463,5,458
קרית מוצקין,8200,64,483,2,481
קרית מוצקין,8200,65,583,1,582
קרית מוצקין,8200,66,567,5,562
קרית מוצקין,8200,67,388,9,379
קרית מוצקין,8200,68,321,2,319
קרית מוצקין,8200,69,328,4,324
קרית מוצקין,8200,70,408,4,404
קרית מוצקין,8200,71,540,4,536
קרית מלאכי,1034,1,493,3,490
קרית מלאכי,1034,2,420,12,408
קרית מלאכי,1034,3,394,4,390
קרית מלאכי,1034,4,473,3,470
קרית מלאכי,1034,5,336,7,329
קרית מלאכי,1034,6,299,4,295
קרית מלאכי,1034,7,298,8,290
קרית מלאכי,1034,8,427,1,426
קרית מלאכי,1034,9,326,8,318
קרית מלאכי,1034,10,560,6,554
קרית מלאכי,1034,11,343,10,333
קרית מלאכי,1034,12,483,5,478
קרית מלאכי,1034,13,501,7,494
קרית מלאכי,1034,14,397,7,390
קרית מלאכי,1034,15,363,4,359
קרית מלאכי,1034,16,450,4,446
קרית מלאכי,1034,17,472,7,465
קרית מלאכי,1034,18,392,8,384
קרית מלאכי,1034,19,419,4,415
קרית מלאכי,1034,21,481,5,476
קרית מלאכי,1034,22,436,10,426
קרית מלאכי,1034,23,335,7,328
קרית מלאכי,1034,24,502,3,499
קרית מלאכי,1034,28,342,9,333
קרית מלאכי,1034,29,469,5,464
קרית מלאכי,1034,30,321,2,319
קרית מלאכי,1034,950,165,2,163
קרית נטפים,3746,1,306,0,306
קרית ענבים,78,1,229,0,229
קרית עקרון,469,1,559,7,552
קרית עקרון,469,2,525,5,520
קרית עקרון,469,3,406,0,406
קרית עקרון,469,4,419,7,412
קרית עקרון,469,5,557,5,552
קרית עקרון,469,6,470,5,465
קרית עקרון,469,7,383,7,376
קרית עקרון,469,8,383,5,378
קרית עקרון,469,9,417,4,413
קרית עקרון,469,10,469,9,460
קרית עקרון,469,11,408,0,408
קרית עקרון,469,12,411,6,405
קרית עקרון,469,13,406,6,400
קרית שמונה,2800,1,356,6,350
קרית שמונה,2800,2,484,5,479
קרית שמונה,2800,3,406,4,402
קרית שמונה,2800,4,361,2,359
קרית שמונה,2800,5,340,2,338
קרית שמונה,2800,6,302,4,298
קרית שמונה,2800,7,385,3,382
קרית שמונה,2800,8,357,3,354
קרית שמונה,2800,9,396,3,393
קרית שמונה,2800,10,277,2,275
קרית שמונה,2800,11,370,4,366
קרית שמונה,2800,12,367,1,366
קרית שמונה,2800,13,298,4,294
קרית שמונה,2800,14,306,5,301
קרית שמונה,2800,15,431,4,427
קרית שמונה,2800,16,346,4,342
קרית שמונה,2800,17,367,3,364
קרית שמונה,2800,18,235,5,230
קרית שמונה,2800,19,360,3,357
קרית שמונה,2800,20,419,1,418
קרית שמונה,2800,21,446,2,444
קרית שמונה,2800,22,313,2,311
קרית שמונה,2800,23,398,3,395
קרית שמונה,2800,24,397,6,391
קרית שמונה,2800,25,441,2,439
קרית שמונה,2800,26,447,6,441
קרית שמונה,2800,27,375,4,371
קרית שמונה,2800,28,352,1,351
קרית שמונה,2800,29,354,3,351
קרית שמונה,2800,30,299,1,298
קרית שמונה,2800,31,353,4,349
קרני שומרון,3640,1,533,0,533
קרני שומרון,3640,2,602,0,602
קרני שומרון,3640,3,554,6,548
קרני שומרון,3640,4,537,8,529
קרני שומרון,3640,5,427,3,424
קרני שומרון,3640,6,477,0,477
קרני שומרון,3640,7,560,11,549
קשת,4006,1,299,2,297
ראמה,543,1,370,6,364
ראמה,543,2,418,7,411
ראמה,543,3,417,3,414
ראמה,543,4,404,1,403
ראמה,543,5,385,12,373
ראמה,543,6,432,16,416
ראמה,543,7,342,6,336
ראמה,543,8,389,9,380
ראמה,543,9,423,6,417
ראס אל-עין,1334,1,140,2,138
ראס עלי,990,1,205,3,202
ראש העין,2640,1,525,4,521
ראש העין,2640,2,397,3,394
ראש העין,2640,3,414,3,411
ראש העין,2640,4,436,3,433
ראש העין,2640,5,410,2,408
ראש העין,2640,6,391,3,388
ראש העין,2640,7,628,3,625
ראש העין,2640,8,477,11,466
ראש העין,2640,9,486,4,482
ראש העין,2640,10,505,11,494
ראש העין,2640,11,400,2,398
ראש העין,2640,12,349,3,346
ראש העין,2640,13,395,3,392
ראש העין,2640,14,433,1,432
ראש העין,2640,15,454,6,448
ראש העין,2640,16,453,4,449
ראש העין,2640,17,402,7,395
ראש העין,2640,18,606,5,601
ראש העין,2640,19,536,2,534
ראש העין,2640,20,450,3,447
ראש העין,2640,21,434,1,433
ראש העין,2640,22,486,1,485
ראש העין,2640,23,485,1,484
ראש העין,2640,24,386,0,386
ראש העין,2640,25,443,1,442
ראש העין,2640,26,405,1,404
ראש העין,2640,27,423,4,419
ראש העין,2640,28,508,5,503
ראש העין,2640,29,575,1,574
ראש העין,2640,30,410,1,409
ראש העין,2640,31,508,1,507
ראש העין,2640,32,454,3,451
ראש העין,2640,33,442,0,442
ראש העין,2640,34,450,0,450
ראש העין,2640,35,511,5,506
ראש העין,2640,36,555,6,549
ראש העין,2640,37,406,2,404
ראש העין,2640,38,491,4,487
ראש העין,2640,39,409,1,408
ראש העין,2640,40,474,4,470
ראש העין,2640,41,483,7,476
ראש העין,2640,42,422,3,419
ראש העין,2640,43,354,1,353
ראש העין,2640,44,410,6,404
ראש העין,2640,45,430,1,429
ראש העין,2640,46,398,1,397
ראש העין,2640,47,379,3,376
ראש העין,2640,49,376,2,374
ראש העין,2640,50,397,1,396
ראש העין,2640,51,459,3,456
ראש העין,2640,52,569,3,566
ראש העין,2640,53,395,3,392
ראש העין,2640,54,370,1,369
ראש פינה,26,1,518,2,516
ראש פינה,26,2,577,1,576
ראש פינה,26,3,525,1,524
ראש צורים,3602,1,412,1,411
ראשון לציון,8300,2,373,6,367
ראשון לציון,8300,3,290,1,289
ראשון לציון,8300,4,319,1,318
ראשון לציון,8300,5,358,5,353
ראשון לציון,8300,6,420,23,397
ראשון לציון,8300,7,386,12,374
ראשון לציון,8300,8,433,9,424
ראשון לציון,8300,9,353,4,349
ראשון לציון,8300,10,286,5,281
ראשון לציון,8300,11,236,3,233
ראשון לציון,8300,12,342,6,336
ראשון לציון,8300,13,453,2,451
ראשון לציון,8300,14,447,6,441
ראשון לציון,8300,15,421,5,416
ראשון לציון,8300,16,520,1,519
ראשון לציון,8300,17,374,3,371
ראשון לציון,8300,18,408,3,405
ראשון לציון,8300,19,428,6,422
ראשון לציון,8300,20,409,4,405
ראשון לציון,8300,21,423,6,417
ראשון לציון,8300,22,461,2,459
ראשון לציון,8300,23,215,8,207
ראשון לציון,8300,24,403,1,402
ראשון לציון,8300,25,388,3,385
ראשון לציון,8300,26,424,9,415
ראשון לציון,8300,27,293,4,289
ראשון לציון,8300,28,378,5,373
ראשון לציון,8300,29,358,0,358
ראשון לציון,8300,30,337,4,333
ראשון לציון,8300,31,353,2,351
ראשון לציון,8300,32,413,9,404
ראשון לציון,8300,33,370,5,365
ראשון לציון,8300,34,386,2,384
ראשון לציון,8300,35,403,2,401
ראשון לציון,8300,36,362,5,357
ראשון לציון,8300,37,220,4,216
ראשון לציון,8300,38,364,5,359
ראשון לציון,8300,39,552,2,550
ראשון לציון,8300,40,458,3,455
ראשון לציון,8300,41,411,1,410
ראשון לציון,8300,42,336,1,335
ראשון לציון,8300,43,499,5,494
ראשון לציון,8300,44,302,2,300
ראשון לציון,8300,45,329,6,323
ראשון לציון,8300,46,361,6,355
ראשון לציון,8300,47,490,3,487
ראשון לציון,8300,48,340,2,338
ראשון לציון,8300,49,442,2,440
ראשון לציון,8300,50,363,2,361
ראשון לציון,8300,51,608,8,600
ראשון לציון,8300,52,435,6,429
ראשון לציון,8300,53,557,7,550
ראשון לציון,8300,54,469,6,463
ראשון לציון,8300,55,357,3,354
ראשון לציון,8300,56,396,3,393
ראשון לציון,8300,57,576,6,570
ראשון לציון,8300,58,470,2,468
ראשון לציון,8300,59,515,1,514
ראשון לציון,8300,60,543,6,537
ראשון לציון,8300,61,320,4,316
ראשון לציון,8300,62,409,10,399
ראשון לציון,8300,63,350,8,342
ראשון לציון,8300,64,407,7,400
ראשון לציון,8300,65,358,0,358
ראשון לציון,8300,66,426,4,422
ראשון לציון,8300,67,406,7,399
ראשון לציון,8300,68,532,2,530
ראשון לציון,8300,69,471,3,468
ראשון לציון,8300,70,418,7,411
ראשון לציון,8300,71,388,8,380
ראשון לציון,8300,72,549,3,546
ראשון לציון,8300,73,438,3,435
ראשון לציון,8300,74,457,1,456
ראשון לציון,8300,75,346,4,342
ראשון לציון,8300,76,342,1,341
ראשון לציון,8300,77,403,1,402
ראשון לציון,8300,78,520,2,518
ראשון לציון,8300,79,394,3,391
ראשון לציון,8300,80,389,0,389
ראשון לציון,8300,81,325,3,322
ראשון לציון,8300,82,467,10,457
ראשון לציון,8300,83,378,2,376
ראשון לציון,8300,84,487,2,485
ראשון לציון,8300,85,376,5,371
ראשון לציון,8300,86,357,3,354
ראשון לציון,8300,87,388,6,382
ראשון לציון,8300,88,336,2,334
ראשון לציון,8300,89,402,2,400
ראשון לציון,8300,90,394,1,393
ראשון לציון,8300,91,473,1,472
ראשון לציון,8300,92,500,4,496
ראשון לציון,8300,93,327,5,322
ראשון לציון,8300,94,388,0,388
ראשון לציון,8300,95,369,5,364
ראשון לציון,8300,96,361,12,349
ראשון לציון,8300,97,601,3,598
ראשון לציון,8300,98,314,5,309
ראשון לציון,8300,99,414,8,406
ראשון לציון,8300,100,343,3,340
ראשון לציון,8300,101,364,7,357
ראשון לציון,8300,102,368,4,364
ראשון לציון,8300,103,445,6,439
ראשון לציון,8300,104,438,0,438
ראשון לציון,8300,105,307,6,301
ראשון לציון,8300,106,470,6,464
ראשון לציון,8300,107,461,4,457
ראשון לציון,8300,108,475,4,471
ראשון לציון,8300,109,432,5,427
ראשון לציון,8300,110,440,1,439
ראשון לציון,8300,111,354,5,349
ראשון לציון,8300,112,435,2,433
ראשון לציון,8300,113,371,1,370
ראשון לציון,8300,114,338,3,335
ראשון לציון,8300,115,348,3,345
ראשון לציון,8300,116,279,2,277
ראשון לציון,8300,117,381,3,378
ראשון לציון,8300,118,394,2,392
ראשון לציון,8300,119,420,8,412
ראשון לציון,8300,120,442,7,435
ראשון לציון,8300,121,266,6,260
ראשון לציון,8300,122,343,4,339
ראשון לציון,8300,123,285,5,280
ראשון לציון,8300,124,555,4,551
ראשון לציון,8300,125,322,5,317
ראשון לציון,8300,126,436,6,430
ראשון לציון,8300,127,390,5,385
ראשון לציון,8300,128,425,4,421
ראשון לציון,8300,129,355,11,344
ראשון לציון,8300,130,374,4,370
ראשון לציון,8300,131,389,1,388
ראשון לציון,8300,132,349,7,342
ראשון לציון,8300,133,314,1,313
ראשון לציון,8300,134,437,5,432
ראשון לציון,8300,135,403,3,400
ראשון לציון,8300,136,442,7,435
ראשון לציון,8300,137,449,5,444
ראשון לציון,8300,138,346,1,345
ראשון לציון,8300,139,337,1,336
ראשון לציון,8300,140,545,6,539
ראשון לציון,8300,141,445,2,443
ראשון לציון,8300,142,270,3,267
ראשון לציון,8300,143,431,2,429
ראשון לציון,8300,144,396,4,392
ראשון לציון,8300,145,381,6,375
ראשון לציון,8300,146,547,8,539
ראשון לציון,8300,147,502,4,498
ראשון לציון,8300,148,436,0,436
ראשון לציון,8300,149,469,1,468
ראשון לציון,8300,150,614,2,612
ראשון לציון,8300,151,373,2,371
ראשון לציון,8300,152,521,1,520
ראשון לציון,8300,153,372,3,369
ראשון לציון,8300,154,355,1,354
ראשון לציון,8300,155,519,3,516
ראשון לציון,8300,156,440,3,437
ראשון לציון,8300,157,580,1,579
ראשון לציון,8300,158,411,3,408
ראשון לציון,8300,159,516,1,515
ראשון לציון,8300,160,349,2,347
ראשון לציון,8300,161,341,4,337
ראשון לציון,8300,162,448,3,445
ראשון לציון,8300,163,354,5,349
ראשון לציון,8300,164,377,5,372
ראשון לציון,8300,165,456,4,452
ראשון לציון,8300,166,271,8,263
ראשון לציון,8300,167,575,5,570
ראשון לציון,8300,168,496,5,491
ראשון לציון,8300,169,417,3,414
ראשון לציון,8300,170,384,4,380
ראשון לציון,8300,171,498,2,496
ראשון לציון,8300,172,529,2,527
ראשון לציון,8300,173,434,3,431
ראשון לציון,8300,174,550,5,545
ראשון לציון,8300,175,496,1,495
ראשון לציון,8300,176,516,8,508
ראשון לציון,8300,178,491,7,484
ראשון לציון,8300,179,325,4,321
ראשון לציון,8300,180,560,0,560
ראשון לציון,8300,181,379,2,377
ראשון לציון,8300,182,352,0,352
ראשון לציון,8300,183,485,3,482
ראשון לציון,8300,184,248,3,245
ראשון לציון,8300,185,627,0,627
ראשון לציון,8300,186,469,0,469
ראשון לציון,8300,187,429,1,428
ראשון לציון,8300,188,610,9,601
ראשון לציון,8300,189,435,2,433
ראשון לציון,8300,190,585,2,583
ראשון לציון,8300,191,523,3,520
ראשון לציון,8300,192,527,5,522
ראשון לציון,8300,193,521,5,516
ראשון לציון,8300,194,520,3,517
ראשון לציון,8300,195,445,0,445
ראשון לציון,8300,196,466,1,465
ראשון לציון,8300,197,522,4,518
ראשון לציון,8300,198,445,2,443
ראשון לציון,8300,199,415,2,413
ראשון לציון,8300,200,435,2,433
ראשון לציון,8300,201,557,0,557
ראשון לציון,8300,202,543,7,536
ראשון לציון,8300,203,311,4,307
ראשון לציון,8300,204,420,3,417
ראשון לציון,8300,205,526,3,523
ראשון לציון,8300,206,499,30,469
ראשון לציון,8300,207,504,7,497
ראשון לציון,8300,208,536,4,532
ראשון לציון,8300,209,346,4,342
ראשון לציון,8300,210,431,4,427
ראשון לציון,8300,211,540,4,536
ראשון לציון,8300,212,515,4,511
ראשון לציון,8300,213,371,3,368
ראשון לציון,8300,214,284,3,281
ראשון לציון,8300,215,369,4,365
ראשון לציון,8300,216,450,0,450
ראשון לציון,8300,217,378,2,376
ראשון לציון,8300,218,356,1,355
ראשון לציון,8300,219,534,5,529
ראשון לציון,8300,220,469,4,465
ראשון לציון,8300,221,556,6,550
ראשון לציון,8300,222,424,0,424
ראשון לציון,8300,223,315,1,314
ראשון לציון,8300,224,422,0,422
ראשון לציון,8300,225,399,0,399
ראשון לציון,8300,226,485,0,485
ראשון לציון,8300,227,371,4,367
ראשון לציון,8300,228,306,5,301
ראשון לציון,8300,229,534,2,532
ראשון לציון,8300,230,350,4,346
ראשון לציון,8300,231,471,0,471
ראשון לציון,8300,232,295,3,292
ראשון לציון,8300,233,393,8,385
ראשון לציון,8300,234,295,1,294
ראשון לציון,8300,235,426,4,422
ראשון לציון,8300,236,398,2,396
ראשון לציון,8300,237,275,2,273
ראשון לציון,8300,238,430,11,419
ראשון לציון,8300,239,411,1,410
ראשון לציון,8300,240,397,1,396
ראשון לציון,8300,241,335,1,334
ראשון לציון,8300,242,447,2,445
ראשון לציון,8300,243,322,2,320
ראשון לציון,8300,244,236,8,228
ראשון לציון,8300,245,435,2,433
ראשון לציון,8300,246,309,4,305
ראשון לציון,8300,247,323,0,323
ראשון לציון,8300,248,382,3,379
ראשון לציון,8300,249,553,4,549
ראשון לציון,8300,250,471,8,463
ראשון לציון,8300,251,364,4,360
ראשון לציון,8300,252,372,0,372
ראשון לציון,8300,253,366,4,362
ראשון לציון,8300,254,368,0,368
ראשון לציון,8300,255,393,1,392
ראשון לציון,8300,256,394,7,387
ראשון לציון,8300,257,306,7,299
ראשון לציון,8300,258,364,2,362
ראשון לציון,8300,259,458,2,456
ראשון לציון,8300,260,476,1,475
ראשון לציון,8300,261,442,3,439
ראשון לציון,8300,262,540,6,534
ראשון לציון,8300,263,400,0,400
ראשון לציון,8300,264,337,2,335
ראשון לציון,8300,265,592,0,592
ראשון לציון,8300,266,451,5,446
ראשון לציון,8300,267,536,2,534
ראשון לציון,8300,268,334,2,332
ראשון לציון,8300,269,560,8,552
ראשון לציון,8300,270,512,0,512
ראשון לציון,8300,271,488,1,487
ראשון לציון,8300,272,342,5,337
ראשון לציון,8300,273,503,2,501
ראשון לציון,8300,274,590,0,590
ראשון לציון,8300,275,412,0,412
ראשון לציון,8300,276,515,1,514
ראשון לציון,8300,277,465,2,463
ראשון לציון,8300,278,413,1,412
ראשון לציון,8300,279,588,1,587
ראשון לציון,8300,280,497,2,495
ראשון לציון,8300,281,615,5,610
ראשון לציון,8300,282,483,1,482
ראשון לציון,8300,283,454,1,453
ראשון לציון,8300,284,526,0,526
ראשון לציון,8300,285,478,1,477
ראשון לציון,8300,286,528,0,528
ראשון לציון,8300,287,556,2,554
ראשון לציון,8300,288,404,1,403
ראשון לציון,8300,289,344,5,339
ראשון לציון,8300,290,534,4,530
ראשון לציון,8300,291,548,3,545
ראשון לציון,8300,292,541,5,536
ראשון לציון,8300,293,285,2,283
ראשון לציון,8300,294,363,0,363
ראשון לציון,8300,295,411,1,410
ראשון לציון,8300,297,509,6,503
ראשון לציון,8300,298,383,2,381
ראשון לציון,8300,299,312,1,311
ראשון לציון,8300,300,313,7,306
ראשון לציון,8300,301,397,1,396
ראשון לציון,8300,302,494,4,490
ראשון לציון,8300,303,427,9,418
ראשון לציון,8300,304,315,3,312
ראשון לציון,8300,305,444,5,439
ראשון לציון,8300,306,455,4,451
ראשון לציון,8300,307,416,4,412
ראשון לציון,8300,309,524,8,516
ראשון לציון,8300,310,467,7,460
ראשון לציון,8300,311,433,6,427
ראשון לציון,8300,312,464,1,463
ראשון לציון,8300,313,494,1,493
ראשון לציון,8300,314,512,7,505
ראשון לציון,8300,315,450,4,446
ראשון לציון,8300,316,603,4,599
ראשון לציון,8300,317,374,5,369
ראשון לציון,8300,318,331,1,330
ראשון לציון,8300,320,410,6,404
ראשון לציון,8300,321,290,3,287
ראשון לציון,8300,325,423,1,422
ראשון לציון,8300,327,333,3,330
ראשון לציון,8300,330,352,3,349
ראשון לציון,8300,335,472,4,468
ראשון לציון,8300,501,625,1,624
ראשון לציון,8300,502,408,2,406
ראשון לציון,8300,503,419,6,413
ראשון לציון,8300,504,589,1,588
ראשון לציון,8300,505,633,1,632
ראשון לציון,8300,950,180,4,176
ראשון לציון,8300,953,477,1,476
ראשון לציון,8300,954,451,2,449
ראשון לציון,8300,956,120,0,120
רבבה,3795,1,716,1,715
רבדים,564,1,383,1,382
רביבים,354,1,451,0,451
רגבה,390,1,323,1,322
רגבה,390,2,314,2,312
רגבים,444,1,261,2,259
רהט,1161,1,380,3,377
רהט,1161,2,382,7,375
רהט,1161,3,299,5,294
רהט,1161,4,217,4,213
רהט,1161,5,360,3,357
רהט,1161,6,471,2,469
רהט,1161,7,411,0,411
רהט,1161,8,266,4,262
רהט,1161,9,437,8,429
רהט,1161,10,318,0,318
רהט,1161,11,508,10,498
רהט,1161,12,328,8,320
רהט,1161,13,317,2,315
רהט,1161,14,391,7,384
רהט,1161,15,361,5,356
רהט,1161,16,259,5,254
רהט,1161,17,336,8,328
רהט,1161,18,432,1,431
רהט,1161,19,366,3,363
רהט,1161,20,338,5,333
רהט,1161,21,276,1,275
רהט,1161,22,367,4,363
רהט,1161,23,419,11,408
רהט,1161,24,425,3,422
רהט,1161,25,345,0,345
רהט,1161,26,431,2,429
רהט,1161,27,354,2,352
רהט,1161,28,301,3,298
רהט,1161,30,329,6,323
רהט,1161,31,409,3,406
רהט,1161,32,315,7,308
רהט,1161,33,459,2,457
רהט,1161,34,375,4,371
רהט,1161,35,321,6,315
רהט,1161,36,332,10,322
רהט,1161,37,453,5,448
רהט,1161,38,498,1,497
רהט,1161,39,265,2,263
רהט,1161,40,340,4,336
רהט,1161,41,308,3,305
רהט,1161,42,229,3,226
רהט,1161,43,352,3,349
רהט,1161,44,342,2,340
רווחה,2051,1,332,0,332
רוויה,2016,1,152,2,150
רוחמה,362,1,305,4,301
רומאנה,539,1,498,5,493
רומת הייב,997,1,192,9,183
רומת הייב,997,2,274,5,269
רועי,3619,1,154,0,154
רחוב,854,1,221,4,217
רחובות,8400,1,539,5,534
רחובות,8400,2,353,4,349
רחובות,8400,3,540,3,537
רחובות,8400,4,399,18,381
רחובות,8400,5,406,4,402
רחובות,8400,6,351,7,344
רחובות,8400,7,315,7,308
רחובות,8400,8,393,9,384
רחובות,8400,9,371,6,365
רחובות,8400,10,421,2,419
רחובות,8400,11,300,1,299
רחובות,8400,12,365,3,362
רחובות,8400,13,430,1,429
רחובות,8400,14,477,4,473
רחובות,8400,15,490,2,488
רחובות,8400,16,457,3,454
רחובות,8400,17,415,5,410
רחובות,8400,18,433,0,433
רחובות,8400,19,422,2,420
רחובות,8400,20,464,9,455
רחובות,8400,21,358,2,356
רחובות,8400,22,510,4,506
רחובות,8400,23,534,7,527
רחובות,8400,24,356,2,354
רחובות,8400,25,240,5,235
רחובות,8400,26,448,3,445
רחובות,8400,27,453,4,449
רחובות,8400,28,354,2,352
רחובות,8400,29,437,3,434
רחובות,8400,30,540,4,536
רחובות,8400,31,489,2,487
רחובות,8400,32,358,5,353
רחובות,8400,33,424,6,418
רחובות,8400,34,355,2,353
רחובות,8400,35,446,3,443
רחובות,8400,36,442,2,440
רחובות,8400,37,505,2,503
רחובות,8400,38,359,5,354
רחובות,8400,39,350,11,339
רחובות,8400,40,409,1,408
רחובות,8400,41,413,9,404
רחובות,8400,42,461,8,453
רחובות,8400,43,506,6,500
רחובות,8400,44,375,2,373
רחובות,8400,45,472,6,466
רחובות,8400,46,466,3,463
רחובות,8400,47,395,6,389
רחובות,8400,48,292,6,286
רחובות,8400,49,422,2,420
רחובות,8400,50,552,2,550
רחובות,8400,51,428,3,425
רחובות,8400,52,388,2,386
רחובות,8400,53,401,1,400
רחובות,8400,54,385,1,384
רחובות,8400,55,407,6,401
רחובות,8400,56,302,3,299
רחובות,8400,57,260,5,255
רחובות,8400,58,441,8,433
רחובות,8400,59,292,2,290
רחובות,8400,60,457,3,454
רחובות,8400,61,306,3,303
רחובות,8400,62,529,3,526
רחובות,8400,63,446,3,443
רחובות,8400,64,408,0,408
רחובות,8400,65,391,6,385
רחובות,8400,66,368,1,367
רחובות,8400,67,586,5,581
רחובות,8400,68,448,2,446
רחובות,8400,69,476,7,469
רחובות,8400,70,377,5,372
רחובות,8400,71,437,3,434
רחובות,8400,72,543,7,536
רחובות,8400,73,429,1,428
רחובות,8400,74,461,5,456
רחובות,8400,75,564,11,553
רחובות,8400,76,517,11,506
רחובות,8400,77,604,5,599
רחובות,8400,78,305,2,303
רחובות,8400,79,407,3,404
רחובות,8400,80,535,0,535
רחובות,8400,81,438,7,431
רחובות,8400,82,375,12,363
רחובות,8400,83,393,3,390
רחובות,8400,84,463,1,462
רחובות,8400,85,500,0,500
רחובות,8400,86,378,3,375
רחובות,8400,87,517,2,515
רחובות,8400,88,454,1,453
רחובות,8400,89,380,1,379
רחובות,8400,90,434,4,430
רחובות,8400,91,403,1,402
רחובות,8400,92,501,3,498
רחובות,8400,93,402,5,397
רחובות,8400,94,281,0,281
רחובות,8400,95,378,6,372
רחובות,8400,96,356,3,353
רחובות,8400,97,571,2,569
רחובות,8400,98,487,4,483
רחובות,8400,99,446,2,444
רחובות,8400,100,487,5,482
רחובות,8400,101,372,5,367
רחובות,8400,102,458,4,454
רחובות,8400,103,417,2,415
רחובות,8400,104,543,3,540
רחובות,8400,105,568,2,566
רחובות,8400,106,391,5,386
רחובות,8400,107,325,3,322
רחובות,8400,108,412,7,405
רחובות,8400,109,299,6,293
רחובות,8400,110,404,5,399
רחובות,8400,111,490,4,486
רחובות,8400,112,609,2,607
רחובות,8400,113,292,2,290
רחובות,8400,114,396,2,394
רחובות,8400,115,514,8,506
רחובות,8400,116,459,5,454
רחובות,8400,117,310,16,294
רחובות,8400,118,454,4,450
רחובות,8400,119,358,4,354
רחובות,8400,120,622,3,619
רחובות,8400,121,457,2,455
רחובות,8400,122,520,3,517
רחובות,8400,123,548,4,544
רחובות,8400,124,500,3,497
רחובות,8400,125,540,2,538
רחובות,8400,126,375,2,373
רחובות,8400,127,501,3,498
רחובות,8400,128,507,1,506
רחובות,8400,129,408,6,402
רחובות,8400,130,383,7,376
רחובות,8400,131,584,2,582
רחובות,8400,132,587,1,586
רחובות,8400,133,280,10,270
רחובות,8400,134,514,5,509
רחובות,8400,135,461,3,458
רחובות,8400,136,411,3,408
רחובות,8400,137,559,6,553
רחובות,8400,139,504,1,503
רחובות,8400,140,520,1,519
רחובות,8400,141,539,5,534
רחובות,8400,142,434,1,433
רחובות,8400,143,352,3,349
רחובות,8400,144,533,1,532
רחובות,8400,145,318,1,317
רחובות,8400,146,365,4,361
רחובות,8400,147,308,3,305
רחובות,8400,148,551,0,551
רחובות,8400,149,410,4,406
רחובות,8400,150,459,3,456
רחובות,8400,151,534,0,534
רחובות,8400,152,530,3,527
רחובות,8400,153,448,0,448
רחובות,8400,154,516,2,514
רחובות,8400,155,594,1,593
רחובות,8400,156,469,1,468
רחובות,8400,157,431,2,429
רחובות,8400,158,311,5,306
רחובות,8400,159,324,2,322
רחובות,8400,950,272,0,272
רחובות,8400,951,138,0,138
רחובות,8400,952,693,3,690
רחלים,3822,1,199,0,199
ריחאניה,540,1,277,2,275
ריחאניה,540,2,219,1,218
ריחן,3568,1,100,1,99
ריינה,542,1,452,3,449
ריינה,542,2,582,1,581
ריינה,542,3,411,2,409
ריינה,542,4,405,2,403
ריינה,542,5,399,4,395
ריינה,542,6,386,7,379
ריינה,542,7,476,3,473
ריינה,542,8,475,6,469
ריינה,542,9,470,8,462
ריינה,542,10,418,5,413
ריינה,542,11,370,11,359
ריינה,542,12,502,2,500
ריינה,542,13,391,4,387
ריינה,542,14,393,7,386
ריינה,542,15,407,3,404
רימונים,3565,1,317,2,315
רינתיה,616,1,541,2,539
רכסים,922,1,447,0,447
רכסים,922,2,447,6,441
רכסים,922,3,455,7,448
רכסים,922,4,401,0,401
רכסים,922,5,497,4,493
רכסים,922,6,638,5,633
רכסים,922,7,529,16,513
רכסים,922,8,410,8,402
רכסים,922,9,433,5,428
רכסים,922,10,434,4,430
רם-און,1069,1,459,3,456
רמות השבים,206,1,468,3,465
רמות השבים,206,2,340,1,339
רמות מאיר,735,1,385,1,384
רמות מנשה,445,1,620,1,619
רמות נפתלי,372,1,305,2,303
רמות,4702,1,324,0,324
רמלה,8500,1,334,12,322
רמלה,8500,2,453,5,448
רמלה,8500,3,363,9,354
רמלה,8500,4,354,7,347
רמלה,8500,5,332,7,325
רמלה,8500,6,398,12,386
רמלה,8500,7,355,34,321
רמלה,8500,8,415,3,412
רמלה,8500,9,331,5,326
רמלה,8500,10,299,4,295
רמלה,8500,11,442,7,435
רמלה,8500,12,395,5,390
רמלה,8500,13,501,16,485
רמלה,8500,14,452,3,449
רמלה,8500,15,454,6,448
רמלה,8500,16,500,2,498
רמלה,8500,17,441,6,435
רמלה,8500,18,333,4,329
רמלה,8500,19,375,5,370
רמלה,8500,20,264,4,260
רמלה,8500,21,346,11,335
רמלה,8500,22,349,16,333
רמלה,8500,23,415,3,412
רמלה,8500,24,419,17,402
רמלה,8500,25,360,0,360
רמלה,8500,26,322,2,320
רמלה,8500,27,274,2,272
רמלה,8500,28,246,7,239
רמלה,8500,29,298,7,291
רמלה,8500,30,293,1,292
רמלה,8500,31,381,0,381
רמלה,8500,32,327,7,320
רמלה,8500,33,375,10,365
רמלה,8500,34,364,7,357
רמלה,8500,35,380,3,377
רמלה,8500,36,428,4,424
רמלה,8500,37,342,6,336
רמלה,8500,38,261,5,256
רמלה,8500,39,254,3,251
רמלה,8500,40,270,2,268
רמלה,8500,41,246,1,245
רמלה,8500,42,468,7,461
רמלה,8500,43,412,10,402
רמלה,8500,44,505,6,499
רמלה,8500,45,495,0,495
רמלה,8500,46,477,2,475
רמלה,8500,47,562,2,560
רמלה,8500,48,182,2,180
רמלה,8500,49,311,6,305
רמלה,8500,50,294,3,291
רמלה,8500,51,436,10,426
רמלה,8500,52,407,1,406
רמלה,8500,53,540,9,531
רמלה,8500,54,322,9,313
רמלה,8500,55,317,8,309
רמלה,8500,56,287,5,282
רמלה,8500,57,298,8,290
רמלה,8500,58,231,3,228
רמלה,8500,59,440,3,437
רמלה,8500,60,298,9,289
רמלה,8500,61,377,9,368
רמלה,8500,62,366,8,358
רמלה,8500,63,270,11,259
רמלה,8500,64,543,8,535
רמלה,8500,65,406,10,396
רמלה,8500,66,441,7,434
רמלה,8500,67,410,19,391
רמלה,8500,68,446,6,440
רמלה,8500,69,392,7,385
רמלה,8500,70,334,11,323
רמלה,8500,71,304,5,299
רמלה,8500,72,449,7,442
רמלה,8500,73,450,5,445
רמלה,8500,74,360,3,357
רמלה,8500,75,459,8,451
רמלה,8500,76,345,5,340
רמלה,8500,77,483,6,477
רמלה,8500,78,465,9,456
רמלה,8500,79,389,6,383
רמלה,8500,80,421,6,415
רמלה,8500,81,362,13,349
רמלה,8500,82,312,2,310
רמלה,8500,83,245,15,230
רמלה,8500,84,216,4,212
רמלה,8500,85,565,4,561
רמלה,8500,86,548,5,543
רמלה,8500,87,447,7,440
רמלה,8500,90,392,12,380
רמלה,8500,95,219,11,208
רמלה,8500,950,321,5,316
רמלה,8500,951,321,4,317
רמת גן,8600,1,467,1,466
רמת גן,8600,2,422,2,420
רמת גן,8600,3,278,0,278
רמת גן,8600,4,424,3,421
רמת גן,8600,5,245,1,244
רמת גן,8600,6,558,4,554
רמת גן,8600,7,517,3,514
רמת גן,8600,8,492,4,488
רמת גן,8600,9,539,6,533
רמת גן,8600,10,446,0,446
רמת גן,8600,11,538,1,537
רמת גן,8600,12,415,0,415
רמת גן,8600,13,447,2,445
רמת גן,8600,14,453,2,451
רמת גן,8600,15,256,1,255
רמת גן,8600,16,325,2,323
רמת גן,8600,17,448,3,445
רמת גן,8600,18,445,2,443
רמת גן,8600,19,570,3,567
רמת גן,8600,20,399,6,393
רמת גן,8600,21,442,1,441
רמת גן,8600,22,404,3,401
רמת גן,8600,23,368,6,362
רמת גן,8600,24,326,1,325
רמת גן,8600,25,318,2,316
רמת גן,8600,26,347,1,346
רמת גן,8600,27,407,1,406
רמת גן,8600,28,377,2,375
רמת גן,8600,29,177,1,176
רמת גן,8600,30,423,0,423
רמת גן,8600,31,352,4,348
רמת גן,8600,32,301,7,294
רמת גן,8600,33,333,3,330
רמת גן,8600,34,490,4,486
רמת גן,8600,35,352,3,349
רמת גן,8600,36,396,2,394
רמת גן,8600,37,365,6,359
רמת גן,8600,38,466,5,461
רמת גן,8600,39,517,5,512
רמת גן,8600,40,476,3,473
רמת גן,8600,41,468,2,466
רמת גן,8600,42,475,0,475
רמת גן,8600,43,454,2,452
רמת גן,8600,44,305,5,300
רמת גן,8600,45,224,0,224
רמת גן,8600,46,360,3,357
רמת גן,8600,47,275,2,273
רמת גן,8600,48,421,2,419
רמת גן,8600,49,526,3,523
רמת גן,8600,50,321,3,318
רמת גן,8600,51,393,0,393
רמת גן,8600,52,340,4,336
רמת גן,8600,53,351,1,350
רמת גן,8600,54,374,1,373
רמת גן,8600,55,536,5,531
רמת גן,8600,56,538,1,537
רמת גן,8600,57,439,1,438
רמת גן,8600,58,438,3,435
רמת גן,8600,59,346,4,342
רמת גן,8600,60,313,2,311
רמת גן,8600,61,318,2,316
רמת גן,8600,67,425,6,419
רמת גן,8600,68,446,1,445
רמת גן,8600,69,532,10,522
רמת גן,8600,70,279,2,277
רמת גן,8600,71,393,1,392
רמת גן,8600,72,458,5,453
רמת גן,8600,73,426,3,423
רמת גן,8600,74,314,6,308
רמת גן,8600,81,263,3,260
רמת גן,8600,82,389,6,383
רמת גן,8600,83,441,2,439
רמת גן,8600,84,326,3,323
רמת גן,8600,85,303,4,299
רמת גן,8600,86,325,4,321
רמת גן,8600,87,219,1,218
רמת גן,8600,87,143,0,143
רמת גן,8600,88,383,2,381
רמת גן,8600,89,428,2,426
רמת גן,8600,99,398,3,395
רמת גן,8600,100,321,3,318
רמת גן,8600,101,422,3,419
רמת גן,8600,102,255,2,253
רמת גן,8600,103,201,1,200
רמת גן,8600,104,252,0,252
רמת גן,8600,105,330,3,327
רמת גן,8600,106,355,4,351
רמת גן,8600,107,294,4,290
רמת גן,8600,108,363,5,358
רמת גן,8600,110,486,4,482
רמת גן,8600,113,392,0,392
רמת גן,8600,114,393,4,389
רמת גן,8600,115,445,0,445
רמת גן,8600,116,432,2,430
רמת גן,8600,117,289,2,287
רמת גן,8600,118,465,7,458
רמת גן,8600,119,455,1,454
רמת גן,8600,125,406,4,402
רמת גן,8600,126,432,7,425
רמת גן,8600,127,304,4,300
רמת גן,8600,129,305,3,302
רמת גן,8600,130,389,4,385
רמת גן,8600,131,363,5,358
רמת גן,8600,132,343,2,341
רמת גן,8600,139,433,2,431
רמת גן,8600,140,463,6,457
רמת גן,8600,141,369,3,366
רמת גן,8600,142,436,2,434
רמת גן,8600,143,443,2,441
רמת גן,8600,144,470,6,464
רמת גן,8600,145,551,4,547
רמת גן,8600,146,332,2,330
רמת גן,8600,147,495,4,491
רמת גן,8600,148,507,2,505
רמת גן,8600,149,553,2,551
רמת גן,8600,150,533,4,529
רמת גן,8600,151,479,3,476
רמת גן,8600,153,250,1,249
רמת גן,8600,154,373,4,369
רמת גן,8600,156,291,3,288
רמת גן,8600,157,364,3,361
רמת גן,8600,158,452,2,450
רמת גן,8600,159,441,5,436
רמת גן,8600,160,395,1,394
רמת גן,8600,163,452,5,447
רמת גן,8600,164,521,5,516
רמת גן,8600,165,355,1,354
רמת גן,8600,166,420,1,419
רמת גן,8600,167,458,8,450
רמת גן,8600,168,396,8,388
רמת גן,8600,169,437,2,435
רמת גן,8600,178,503,3,500
רמת גן,8600,180,588,2,586
רמת גן,8600,182,564,0,564
רמת גן,8600,183,571,6,565
רמת גן,8600,184,419,2,417
רמת גן,8600,187,433,2,431
רמת גן,8600,188,559,3,556
רמת גן,8600,189,574,2,572
רמת גן,8600,190,344,1,343
רמת גן,8600,191,544,1,543
רמת גן,8600,192,509,1,508
רמת גן,8600,193,493,3,490
רמת גן,8600,194,558,2,556
רמת גן,8600,195,398,1,397
רמת גן,8600,196,512,6,506
רמת גן,8600,197,410,1,409
רמת גן,8600,198,433,1,432
רמת גן,8600,199,434,1,433
רמת גן,8600,200,499,3,496
רמת גן,8600,201,378,1,377
רמת גן,8600,202,418,12,406
רמת גן,8600,203,300,0,300
רמת גן,8600,204,350,3,347
רמת גן,8600,205,335,3,332
רמת גן,8600,206,404,1,403
רמת גן,8600,207,411,0,411
רמת גן,8600,208,470,2,468
רמת גן,8600,209,463,3,460
רמת גן,8600,210,357,1,356
רמת גן,8600,211,383,3,380
רמת גן,8600,212,552,3,549
רמת גן,8600,213,515,3,512
רמת גן,8600,214,418,6,412
רמת גן,8600,215,469,4,465
רמת גן,8600,216,497,2,495
רמת גן,8600,217,527,3,524
רמת גן,8600,218,487,2,485
רמת גן,8600,219,535,4,531
רמת גן,8600,220,373,2,371
רמת גן,8600,221,360,3,357
רמת גן,8600,222,422,5,417
רמת גן,8600,223,521,7,514
רמת גן,8600,224,337,3,334
רמת גן,8600,225,416,2,414
רמת גן,8600,226,495,2,493
רמת גן,8600,227,528,2,526
רמת גן,8600,228,635,2,633
רמת גן,8600,229,315,5,310
רמת גן,8600,230,478,7,471
רמת גן,8600,231,479,0,479
רמת גן,8600,232,367,5,362
רמת גן,8600,233,390,10,380
רמת גן,8600,234,421,2,419
רמת גן,8600,235,384,7,377
רמת גן,8600,236,415,0,415
רמת גן,8600,237,525,2,523
רמת גן,8600,238,21,0,21
רמת גן,8600,239,349,2,347
רמת גן,8600,240,588,9,579
רמת גן,8600,241,525,2,523
רמת גן,8600,242,227,0,227
רמת גן,8600,243,369,3,366
רמת גן,8600,244,310,4,306
רמת גן,8600,245,374,1,373
רמת גן,8600,246,514,2,512
רמת גן,8600,247,435,1,434
רמת גן,8600,248,503,0,503
רמת גן,8600,249,548,4,544
רמת גן,8600,250,493,4,489
רמת גן,8600,251,463,5,458
רמת גן,8600,501,320,2,318
רמת גן,8600,502,345,1,344
רמת גן,8600,503,451,1,450
רמת גן,8600,504,461,6,455
רמת גן,8600,505,342,3,339
רמת גן,8600,515,86,1,85
רמת גן,8600,515,76,3,73
רמת גן,8600,521,334,0,334
רמת גן,8600,951,330,3,327
רמת דוד,135,1,269,2,267
רמת הכובש,184,1,261,0,261
רמת הכובש,184,2,223,1,222
רמת השופט,335,1,234,0,234
רמת השופט,335,2,260,0,260
רמת השרון,2650,1,412,6,406
רמת השרון,2650,2,344,1,343
רמת השרון,2650,3,515,3,512
רמת השרון,2650,4,523,7,516
רמת השרון,2650,5,553,1,552
רמת השרון,2650,6,422,0,422
רמת השרון,2650,7,309,2,307
רמת השרון,2650,8,423,5,418
רמת השרון,2650,9,446,1,445
רמת השרון,2650,10,388,0,388
רמת השרון,2650,11,422,2,420
רמת השרון,2650,12,476,2,474
רמת השרון,2650,13,484,3,481
רמת השרון,2650,14,556,1,555
רמת השרון,2650,15,524,7,517
רמת השרון,2650,16,488,2,486
רמת השרון,2650,17,427,1,426
רמת השרון,2650,18,295,1,294
רמת השרון,2650,19,473,0,473
רמת השרון,2650,20,322,2,320
רמת השרון,2650,21,508,3,505
רמת השרון,2650,22,382,4,378
רמת השרון,2650,23,434,1,433
רמת השרון,2650,24,537,3,534
רמת השרון,2650,25,307,1,306
רמת השרון,2650,26,470,2,468
רמת השרון,2650,27,553,1,552
רמת השרון,2650,28,376,0,376
רמת השרון,2650,29,337,1,336
רמת השרון,2650,30,556,2,554
רמת השרון,2650,31,465,2,463
רמת השרון,2650,32,479,4,475
רמת השרון,2650,33,374,1,373
רמת השרון,2650,34,422,2,420
רמת השרון,2650,35,543,0,543
רמת השרון,2650,36,563,0,563
רמת השרון,2650,37,399,1,398
רמת השרון,2650,38,536,5,531
רמת השרון,2650,39,311,1,310
רמת השרון,2650,40,534,4,530
רמת השרון,2650,41,471,4,467
רמת השרון,2650,42,524,2,522
רמת השרון,2650,43,373,1,372
רמת השרון,2650,44,387,2,385
רמת השרון,2650,45,361,6,355
רמת השרון,2650,46,389,0,389
רמת השרון,2650,47,339,0,339
רמת השרון,2650,49,97,0,97
רמת השרון,2650,51,452,1,451
רמת השרון,2650,52,530,0,530
רמת השרון,2650,53,320,0,320
רמת השרון,2650,54,495,0,495
רמת השרון,2650,55,372,1,371
רמת השרון,2650,58,343,2,341
רמת השרון,2650,59,377,1,376
רמת השרון,2650,60,435,3,432
רמת השרון,2650,63,452,0,452
רמת השרון,2650,65,652,0,652
רמת השרון,2650,66,480,2,478
רמת השרון,2650,67,396,0,396
רמת השרון,2650,68,614,2,612
רמת יוחנן,178,1,282,2,280
רמת יוחנן,178,2,281,0,281
רמת ישי,122,1,577,1,576
רמת ישי,122,2,586,3,583
רמת ישי,122,3,482,2,480
רמת ישי,122,4,565,5,560
רמת ישי,122,5,476,0,476
רמת ישי,122,6,441,2,439
רמת ישי,122,7,527,1,526
רמת ישי,122,8,559,3,556
רמת מגשימים,4701,1,354,2,352
רמת צבי,339,1,329,0,329
רמת רזיאל,460,1,338,4,334
רמת רחל,127,1,259,0,259
רנן,789,1,284,2,282
רעים,713,1,279,0,279
רעננה,8700,1,492,3,489
רעננה,8700,2,368,7,361
רעננה,8700,3,486,0,486
רעננה,8700,4,419,2,417
רעננה,8700,5,535,3,532
רעננה,8700,6,539,2,537
רעננה,8700,7,489,6,483
רעננה,8700,8,389,1,388
רעננה,8700,9,464,1,463
רעננה,8700,10,406,7,399
רעננה,8700,11,462,1,461
רעננה,8700,12,456,3,453
רעננה,8700,13,391,5,386
רעננה,8700,14,363,2,361
רעננה,8700,15,437,3,434
רעננה,8700,16,556,0,556
רעננה,8700,17,269,1,268
רעננה,8700,18,367,1,366
רעננה,8700,19,468,0,468
רעננה,8700,20,320,2,318
רעננה,8700,21,330,3,327
רעננה,8700,22,436,1,435
רעננה,8700,23,507,5,502
רעננה,8700,24,321,0,321
רעננה,8700,25,436,5,431
רעננה,8700,26,423,2,421
רעננה,8700,27,448,3,445
רעננה,8700,28,517,2,515
רעננה,8700,29,549,5,544
רעננה,8700,30,488,1,487
רעננה,8700,31,385,6,379
רעננה,8700,32,454,0,454
רעננה,8700,33,404,1,403
רעננה,8700,34,383,1,382
רעננה,8700,35,562,4,558
רעננה,8700,36,445,4,441
רעננה,8700,37,481,4,477
רעננה,8700,38,461,0,461
רעננה,8700,39,401,6,395
רעננה,8700,40,395,1,394
רעננה,8700,41,360,1,359
רעננה,8700,42,377,0,377
רעננה,8700,43,341,1,340
רעננה,8700,44,523,0,523
רעננה,8700,45,457,4,453
רעננה,8700,46,460,3,457
רעננה,8700,47,422,1,421
רעננה,8700,48,464,1,463
רעננה,8700,49,379,1,378
רעננה,8700,50,338,2,336
רעננה,8700,51,457,2,455
רעננה,8700,52,380,2,378
רעננה,8700,53,338,2,336
רעננה,8700,54,451,3,448
רעננה,8700,55,430,1,429
רעננה,8700,56,533,2,531
רעננה,8700,57,525,5,520
רעננה,8700,58,502,2,500
רעננה,8700,59,393,3,390
רעננה,8700,60,436,4,432
רעננה,8700,61,388,2,386
רעננה,8700,62,496,1,495
רעננה,8700,63,50,0,50
רעננה,8700,64,493,0,493
רעננה,8700,65,557,3,554
רעננה,8700,66,482,3,479
רעננה,8700,67,426,1,425
רעננה,8700,68,420,3,417
רעננה,8700,69,486,2,484
רעננה,8700,70,389,1,388
רעננה,8700,71,363,0,363
רעננה,8700,72,537,23,514
רעננה,8700,73,367,2,365
רעננה,8700,74,535,0,535
רעננה,8700,75,464,2,462
רעננה,8700,76,471,4,467
רעננה,8700,77,445,1,444
רעננה,8700,78,411,7,404
רעננה,8700,79,458,1,457
רעננה,8700,80,524,7,517
רעננה,8700,81,341,4,337
רעננה,8700,82,340,6,334
רעננה,8700,83,370,2,368
רעננה,8700,84,338,4,334
רעננה,8700,85,385,3,382
רעננה,8700,86,375,3,372
רעננה,8700,87,343,3,340
רעננה,8700,88,344,2,342
רעננה,8700,89,297,0,297
רעננה,8700,90,315,1,314
רעננה,8700,91,411,1,410
רעננה,8700,92,555,3,552
רעננה,8700,93,507,3,504
רעננה,8700,94,318,4,314
רעננה,8700,95,527,2,525
רעננה,8700,96,523,2,521
רעננה,8700,97,572,5,567
רעננה,8700,98,511,1,510
רעננה,8700,100,434,1,433
רעננה,8700,101,466,3,463
רקפת,1228,1,537,0,537
רשפון,247,1,335,1,334
רשפון,247,2,347,1,346
רשפים,437,1,311,1,310
רתמים,1260,1,177,0,177
שאר ישוב,324,1,321,0,321
שבי ציון,282,1,284,0,284
שבי ציון,282,2,259,0,259
שבי שומרון,3571,1,409,1,408
שבלי - אום אל-גנם,913,1,329,6,323
שבלי - אום אל-גנם,913,2,364,1,363
שבלי - אום אל-גנם,913,3,359,3,356
שבלי - אום אל-גנם,913,4,437,1,436
שבלי - אום אל-גנם,913,6,317,4,313
שבלי - אום אל-גנם,913,7,320,4,316
שגב-שלום,1286,1,425,7,418
שגב-שלום,1286,2,367,4,363
שגב-שלום,1286,3,376,8,368
שגב-שלום,1286,4,417,7,410
שגב-שלום,1286,5,365,3,362
שדה אילן,721,1,304,0,304
שדה אליהו,304,1,393,0,393
שדה אליעזר,861,1,454,3,451
שדה בוקר,885,1,262,1,261
שדה דוד,36,1,203,4,199
שדה ורבורג,284,1,478,1,477
שדה ורבורג,284,2,289,1,288
שדה יואב,293,1,223,0,223
שדה יעקב,142,1,473,0,473
שדה יצחק,2008,1,271,1,270
שדה משה,18,1,299,4,295
שדה נחום,259,1,269,2,267
שדה נחמיה,329,1,502,0,502
שדה ניצן,1058,1,180,0,180
שדה עוזיהו,739,1,341,2,339
שדה עוזיהו,739,2,363,2,361
שדה צבי,2049,1,280,4,276
שדות ים,327,1,279,0,279
שדות ים,327,2,239,0,239
שדות מיכה,27,1,196,1,195
שדי אברהם,1223,1,166,1,165
שדי חמד,2015,1,567,2,565
שדי תרומות,2057,1,231,0,231
שדמה,555,1,278,0,278
שדמות דבורה,306,1,369,1,368
שדמות מחולה,3578,1,263,0,263
שדרות,1031,1,560,5,555
שדרות,1031,2,337,7,330
שדרות,1031,3,263,0,263
שדרות,1031,4,479,4,475
שדרות,1031,5,279,6,273
שדרות,1031,6,452,4,448
שדרות,1031,7,370,8,362
שדרות,1031,8,326,7,319
שדרות,1031,9,241,9,232
שדרות,1031,10,322,9,313
שדרות,1031,11,330,9,321
שדרות,1031,12,262,4,258
שדרות,1031,13,385,6,379
שדרות,1031,14,333,2,331
שדרות,1031,15,518,8,510
שדרות,1031,16,403,1,402
שדרות,1031,17,432,10,422
שדרות,1031,18,306,5,301
שדרות,1031,19,480,5,475
שדרות,1031,20,280,4,276
שדרות,1031,21,382,3,379
שדרות,1031,22,530,3,527
שדרות,1031,23,409,14,395
שדרות,1031,24,391,4,387
שדרות,1031,25,386,3,383
שדרות,1031,26,436,5,431
שדרות,1031,27,407,3,404
שדרות,1031,28,376,5,371
שדרות,1031,30,249,4,245
שואבה,741,1,337,0,337
שובה,761,1,299,3,296
שובל,394,1,390,2,388
שוהם,1304,1,572,1,571
שוהם,1304,2,504,2,502
שוהם,1304,3,336,0,336
שוהם,1304,4,613,0,613
שוהם,1304,5,644,2,642
שוהם,1304,6,403,2,401
שוהם,1304,7,377,1,376
שוהם,1304,8,558,4,554
שוהם,1304,9,466,0,466
שוהם,1304,10,523,2,521
שוהם,1304,11,528,3,525
שוהם,1304,12,608,6,602
שוהם,1304,13,390,2,388
שוהם,1304,14,616,3,613
שוהם,1304,15,505,1,504
שוהם,1304,16,629,1,628
שוהם,1304,17,435,0,435
שוהם,1304,18,430,2,428
שוהם,1304,19,678,1,677
שוהם,1304,20,333,4,329
שוהם,1304,21,348,0,348
שוהם,1304,22,316,1,315
שוהם,1304,23,358,2,356
שומרה,614,1,201,3,198
שומריה,1265,1,231,0,231
שוקדה,415,1,163,1,162
שורש,456,1,458,5,453
שורש,456,2,194,0,194
שורשים,1235,1,273,2,271
שושנת העמקים,224,1,338,2,336
שזור,527,1,199,2,197
שחר,7,1,340,2,338
שיבולים,865,1,213,7,206
שייח' דנון,658,1,374,3,371
שייח' דנון,658,2,416,9,407
שייח' דנון,658,3,487,2,485
שילה,3641,1,310,0,310
שילה,3641,2,636,0,636
שילה,3641,3,364,1,363
שילת,1165,1,351,0,351
שכניה,1160,1,389,0,389
שלווה,873,1,270,0,270
שלוחות,439,1,284,2,282
שלומי,812,1,427,6,421
שלומי,812,2,506,16,490
שלומי,812,3,468,7,461
שלומי,812,4,444,5,439
שלומי,812,5,443,4,439
שלומי,812,6,562,6,556
שלומי,812,7,489,1,488
שמיר,366,1,473,1,472
שמעה,3784,1,214,3,211
שמרת,432,1,258,0,258
שמשית,1337,1,388,0,388
שמשית,1337,2,429,1,428
שמשית,1337,3,441,1,440
שני,1287,1,221,1,220
שניר,1132,1,299,0,299
שעב,538,1,505,0,505
שעב,538,2,449,1,448
שעב,538,3,574,4,570
שעב,538,4,450,3,447
שעב,538,5,475,0,475
שעב,538,6,405,0,405
שעב,538,7,358,3,355
שעל,4009,1,172,2,170
שעלבים,856,1,527,1,526
שער אפרים,661,1,468,1,467
שער אפרים,661,2,367,1,366
שער הגולן,264,1,380,4,376
שער העמקים,237,1,437,1,436
שער מנשה,921,1,13,1,12
שערי תקווה,3720,1,561,4,557
שערי תקווה,3720,2,573,2,571
שערי תקווה,3720,3,606,3,603
שערי תקווה,3720,4,527,1,526
שערי תקווה,3720,5,587,2,585
שפיים,232,1,378,1,377
שפיים,232,2,336,1,335
שפיר,692,1,400,3,397
שפר,846,1,206,0,206
שפרעם,8800,1,465,5,460
שפרעם,8800,2,416,7,409
שפרעם,8800,3,415,3,412
שפרעם,8800,4,477,6,471
שפרעם,8800,5,450,3,447
שפרעם,8800,6,379,6,373
שפרעם,8800,7,360,6,354
שפרעם,8800,8,442,8,434
שפרעם,8800,9,469,5,464
שפרעם,8800,10,453,11,442
שפרעם,8800,11,414,3,411
שפרעם,8800,12,405,3,402
שפרעם,8800,13,426,8,418
שפרעם,8800,14,459,4,455
שפרעם,8800,15,450,8,442
שפרעם,8800,16,470,8,462
שפרעם,8800,17,434,2,432
שפרעם,8800,18,441,5,436
שפרעם,8800,19,386,6,380
שפרעם,8800,20,370,6,364
שפרעם,8800,21,449,2,447
שפרעם,8800,22,378,2,376
שפרעם,8800,23,450,10,440
שפרעם,8800,24,308,1,307
שפרעם,8800,25,319,3,316
שפרעם,8800,26,461,0,461
שפרעם,8800,27,461,7,454
שפרעם,8800,28,354,2,352
שפרעם,8800,29,422,8,414
שפרעם,8800,30,422,0,422
שפרעם,8800,31,408,1,407
שפרעם,8800,32,423,7,416
שפרעם,8800,33,412,4,408
שפרעם,8800,34,357,3,354
שפרעם,8800,35,316,2,314
שפרעם,8800,36,319,2,317
שפרעם,8800,37,354,2,352
שקד,3649,1,399,4,395
שקף,1233,1,274,1,273
שרונה,292,1,347,1,346
שריגים (לי-און),1114,1,258,0,258
שריגים (לי-און),1114,2,272,1,271
שריד,126,1,286,2,284
שריד,126,2,245,2,243
שרשרת,398,1,179,2,177
שתולה,1045,1,161,0,161
שתולים,763,1,492,7,485
שתולים,763,2,458,1,457
תאשור,2062,1,176,1,175
תדהר,2061,1,228,0,228
תובל,1172,1,223,0,223
תומר,3558,1,177,1,176
תושיה,1083,1,227,0,227
תימורים,163,1,465,0,465
תירוש,10,1,218,3,215
תל אביב - יפו,5000,1,406,1,405
תל אביב - יפו,5000,3,446,4,442
תל אביב - יפו,5000,4,248,7,241
תל אביב - יפו,5000,5,370,4,366
תל אביב - יפו,5000,6,368,4,364
תל אביב - יפו,5000,7,545,2,543
תל אביב - יפו,5000,8,482,2,480
תל אביב - יפו,5000,9,404,2,402
תל אביב - יפו,5000,10,421,0,421
תל אביב - יפו,5000,11,514,0,514
תל אביב - יפו,5000,12,574,4,570
תל אביב - יפו,5000,13,384,2,382
תל אביב - יפו,5000,14,305,3,302
תל אביב - יפו,5000,15,371,2,369
תל אביב - יפו,5000,16,396,1,395
תל אביב - יפו,5000,17,313,0,313
תל אביב - יפו,5000,18,436,0,436
תל אביב - יפו,5000,19,538,0,538
תל אביב - יפו,5000,20,283,2,281
תל אביב - יפו,5000,21,679,0,679
תל אביב - יפו,5000,22,543,2,541
תל אביב - יפו,5000,23,586,3,583
תל אביב - יפו,5000,24,597,6,591
תל אביב - יפו,5000,25,532,0,532
תל אביב - יפו,5000,26,564,3,561
תל אביב - יפו,5000,27,531,3,528
תל אביב - יפו,5000,28,549,1,548
תל אביב - יפו,5000,29,471,1,470
תל אביב - יפו,5000,30,395,0,395
תל אביב - יפו,5000,31,583,3,580
תל אביב - יפו,5000,32,538,1,537
תל אביב - יפו,5000,33,347,3,344
תל אביב - יפו,5000,34,465,1,464
תל אביב - יפו,5000,35,481,0,481
תל אביב - יפו,5000,36,477,6,471
תל אביב - יפו,5000,37,566,10,556
תל אביב - יפו,5000,38,516,2,514
תל אביב - יפו,5000,39,516,1,515
תל אביב - יפו,5000,40,641,3,638
תל אביב - יפו,5000,41,497,3,494
תל אביב - יפו,5000,42,441,9,432
תל אביב - יפו,5000,43,561,4,557
תל אביב - יפו,5000,44,436,0,436
תל אביב - יפו,5000,45,368,1,367
תל אביב - יפו,5000,46,557,3,554
תל אביב - יפו,5000,47,373,3,370
תל אביב - יפו,5000,48,571,0,571
תל אביב - יפו,5000,49,447,3,444
תל אביב - יפו,5000,50,497,4,493
תל אביב - יפו,5000,51,481,4,477
תל אביב - יפו,5000,52,486,6,480
תל אביב - יפו,5000,53,391,1,390
תל אביב - יפו,5000,54,490,1,489
תל אביב - יפו,5000,55,468,3,465
תל אביב - יפו,5000,56,508,2,506
תל אביב - יפו,5000,57,455,4,451
תל אביב - יפו,5000,58,609,2,607
תל אביב - יפו,5000,59,455,1,454
תל אביב - יפו,5000,60,543,2,541
תל אביב - יפו,5000,61,394,2,392
תל אביב - יפו,5000,62,322,4,318
תל אביב - יפו,5000,63,303,2,301
תל אביב - יפו,5000,64,454,2,452
תל אביב - יפו,5000,65,447,0,447
תל אביב - יפו,5000,66,198,0,198
תל אביב - יפו,5000,67,388,1,387
תל אביב - יפו,5000,68,308,1,307
תל אביב - יפו,5000,69,466,0,466
תל אביב - יפו,5000,70,499,4,495
תל אביב - יפו,5000,71,379,2,377
תל אביב - יפו,5000,72,336,0,336
תל אביב - יפו,5000,73,349,6,343
תל אביב - יפו,5000,74,437,1,436
תל אביב - יפו,5000,75,355,0,355
תל אביב - יפו,5000,76,430,4,426
תל אביב - יפו,5000,77,498,0,498
תל אביב - יפו,5000,78,297,1,296
תל אביב - יפו,5000,79,421,4,417
תל אביב - יפו,5000,80,447,3,444
תל אביב - יפו,5000,81,441,0,441
תל אביב - יפו,5000,82,529,6,523
תל אביב - יפו,5000,83,397,1,396
תל אביב - יפו,5000,84,361,4,357
תל אביב - יפו,5000,85,506,5,501
תל אביב - יפו,5000,86,438,6,432
תל אביב - יפו,5000,87,593,0,593
תל אביב - יפו,5000,88,337,1,336
תל אביב - יפו,5000,89,428,1,427
תל אביב - יפו,5000,90,373,3,370
תל אביב - יפו,5000,91,437,4,433
תל אביב - יפו,5000,92,442,0,442
תל אביב - יפו,5000,93,454,5,449
תל אביב - יפו,5000,94,366,0,366
תל אביב - יפו,5000,95,385,0,385
תל אביב - יפו,5000,96,384,0,384
תל אביב - יפו,5000,97,554,2,552
תל אביב - יפו,5000,98,482,1,481
תל אביב - יפו,5000,99,408,2,406
תל אביב - יפו,5000,100,582,1,581
תל אביב - יפו,5000,101,473,3,470
תל אביב - יפו,5000,102,435,3,432
תל אביב - יפו,5000,103,402,0,402
תל אביב - יפו,5000,104,401,1,400
תל אביב - יפו,5000,105,456,2,454
תל אביב - יפו,5000,106,578,4,574
תל אביב - יפו,5000,107,502,1,501
תל אביב - יפו,5000,108,567,1,566
תל אביב - יפו,5000,109,433,0,433
תל אביב - יפו,5000,110,486,3,483
תל אביב - יפו,5000,111,276,6,270
תל אביב - יפו,5000,111,241,4,237
תל אביב - יפו,5000,112,463,0,463
תל אביב - יפו,5000,113,555,2,553
תל אביב - יפו,5000,114,622,2,620
תל אביב - יפו,5000,115,560,1,559
תל אביב - יפו,5000,116,469,1,468
תל אביב - יפו,5000,117,452,3,449
תל אביב - יפו,5000,118,370,2,368
תל אביב - יפו,5000,119,328,1,327
תל אביב - יפו,5000,120,391,1,390
תל אביב - יפו,5000,121,448,0,448
תל אביב - יפו,5000,122,376,2,374
תל אביב - יפו,5000,123,333,1,332
תל אביב - יפו,5000,124,394,2,392
תל אביב - יפו,5000,125,222,1,221
תל אביב - יפו,5000,126,440,1,439
תל אביב - יפו,5000,127,338,2,336
תל אביב - יפו,5000,128,375,3,372
תל אביב - יפו,5000,129,312,4,308
תל אביב - יפו,5000,130,402,1,401
תל אביב - יפו,5000,131,406,0,406
תל אביב - יפו,5000,132,332,0,332
תל אביב - יפו,5000,133,229,0,229
תל אביב - יפו,5000,134,337,1,336
תל אביב - יפו,5000,135,424,1,423
תל אביב - יפו,5000,136,265,8,257
תל אביב - יפו,5000,136,217,3,214
תל אביב - יפו,5000,137,351,0,351
תל אביב - יפו,5000,138,505,3,502
תל אביב - יפו,5000,139,268,3,265
תל אביב - יפו,5000,139,218,0,218
תל אביב - יפו,5000,140,425,2,423
תל אביב - יפו,5000,141,576,9,567
תל אביב - יפו,5000,142,417,1,416
תל אביב - יפו,5000,143,438,0,438
תל אביב - יפו,5000,144,519,1,518
תל אביב - יפו,5000,145,348,0,348
תל אביב - יפו,5000,146,342,3,339
תל אביב - יפו,5000,147,361,0,361
תל אביב - יפו,5000,148,508,2,506
תל אביב - יפו,5000,149,310,0,310
תל אביב - יפו,5000,150,355,2,353
תל אביב - יפו,5000,151,264,2,262
תל אביב - יפו,5000,152,384,1,383
תל אביב - יפו,5000,153,530,2,528
תל אביב - יפו,5000,154,458,0,458
תל אביב - יפו,5000,155,415,1,414
תל אביב - יפו,5000,156,437,2,435
תל אביב - יפו,5000,157,515,1,514
תל אביב - יפו,5000,158,525,1,524
תל אביב - יפו,5000,159,290,4,286
תל אביב - יפו,5000,160,341,4,337
תל אביב - יפו,5000,161,346,2,344
תל אביב - יפו,5000,162,334,2,332
תל אביב - יפו,5000,163,568,5,563
תל אביב - יפו,5000,164,300,1,299
תל אביב - יפו,5000,165,386,1,385
תל אביב - יפו,5000,166,280,0,280
תל אביב - יפו,5000,167,480,1,479
תל אביב - יפו,5000,168,385,1,384
תל אביב - יפו,5000,169,298,2,296
תל אביב - יפו,5000,170,472,5,467
תל אביב - יפו,5000,171,353,3,350
תל אביב - יפו,5000,172,334,2,332
תל אביב - יפו,5000,173,345,1,344
תל אביב - יפו,5000,174,491,0,491
תל אביב - יפו,5000,175,420,6,414
תל אביב - יפו,5000,176,418,0,418
תל אביב - יפו,5000,177,443,0,443
תל אביב - יפו,5000,178,432,0,432
תל אביב - יפו,5000,179,406,3,403
תל אביב - יפו,5000,180,425,1,424
תל אביב - יפו,5000,181,459,0,459
תל אביב - יפו,5000,182,413,1,412
תל אביב - יפו,5000,183,431,1,430
תל אביב - יפו,5000,184,354,0,354
תל אביב - יפו,5000,185,459,1,458
תל אביב - יפו,5000,186,430,2,428
תל אביב - יפו,5000,187,381,0,381
תל אביב - יפו,5000,188,437,2,435
תל אביב - יפו,5000,189,494,5,489
תל אביב - יפו,5000,190,505,1,504
תל אביב - יפו,5000,191,375,0,375
תל אביב - יפו,5000,192,438,0,438
תל אביב - יפו,5000,193,430,0,430
תל אביב - יפו,5000,194,458,1,457
תל אביב - יפו,5000,195,502,2,500
תל אביב - יפו,5000,196,353,4,349
תל אביב - יפו,5000,197,429,1,428
תל אביב - יפו,5000,198,432,5,427
תל אביב - יפו,5000,199,541,1,540
תל אביב - יפו,5000,200,572,1,571
תל אביב - יפו,5000,201,459,7,452
תל אביב - יפו,5000,202,485,0,485
תל אביב - יפו,5000,203,462,0,462
תל אביב - יפו,5000,204,264,3,261
תל אביב - יפו,5000,205,404,1,403
תל אביב - יפו,5000,206,363,2,361
תל אביב - יפו,5000,207,466,2,464
תל אביב - יפו,5000,208,423,3,420
תל אביב - יפו,5000,209,355,3,352
תל אביב - יפו,5000,210,421,3,418
תל אביב - יפו,5000,211,353,2,351
תל אביב - יפו,5000,212,303,2,301
תל אביב - יפו,5000,213,379,2,377
תל אביב - יפו,5000,214,371,2,369
תל אביב - יפו,5000,215,294,1,293
תל אביב - יפו,5000,216,373,1,372
תל אביב - יפו,5000,217,351,2,349
תל אביב - יפו,5000,218,462,4,458
תל אביב - יפו,5000,219,328,1,327
תל אביב - יפו,5000,220,489,6,483
תל אביב - יפו,5000,221,390,0,390
תל אביב - יפו,5000,222,255,0,255
תל אביב - יפו,5000,223,381,5,376
תל אביב - יפו,5000,224,506,0,506
תל אביב - יפו,5000,225,405,2,403
תל אביב - יפו,5000,227,382,1,381
תל אביב - יפו,5000,228,357,1,356
תל אביב - יפו,5000,229,427,4,423
תל אביב - יפו,5000,230,382,1,381
תל אביב - יפו,5000,232,358,2,356
תל אביב - יפו,5000,234,375,2,373
תל אביב - יפו,5000,235,316,2,314
תל אביב - יפו,5000,236,285,2,283
תל אביב - יפו,5000,237,300,1,299
תל אביב - יפו,5000,238,373,0,373
תל אביב - יפו,5000,239,425,1,424
תל אביב - יפו,5000,240,411,3,408
תל אביב - יפו,5000,241,565,2,563
תל אביב - יפו,5000,242,246,0,246
תל אביב - יפו,5000,242,225,3,222
תל אביב - יפו,5000,243,380,1,379
תל אביב - יפו,5000,244,329,1,328
תל אביב - יפו,5000,246,405,2,403
תל אביב - יפו,5000,247,475,7,468
תל אביב - יפו,5000,248,415,1,414
תל אביב - יפו,5000,249,476,2,474
תל אביב - יפו,5000,250,483,3,480
תל אביב - יפו,5000,251,342,0,342
תל אביב - יפו,5000,252,499,4,495
תל אביב - יפו,5000,253,378,0,378
תל אביב - יפו,5000,254,424,1,423
תל אביב - יפו,5000,255,508,3,505
תל אביב - יפו,5000,256,539,3,536
תל אביב - יפו,5000,257,510,0,510
תל אביב - יפו,5000,258,353,0,353
תל אביב - יפו,5000,277,289,1,288
תל אביב - יפו,5000,279,395,0,395
תל אביב - יפו,5000,280,256,2,254
תל אביב - יפו,5000,280,227,3,224
תל אביב - יפו,5000,281,408,1,407
תל אביב - יפו,5000,282,316,2,314
תל אביב - יפו,5000,283,439,0,439
תל אביב - יפו,5000,284,390,4,386
תל אביב - יפו,5000,285,433,1,432
תל אביב - יפו,5000,286,417,1,416
תל אביב - יפו,5000,287,448,1,447
תל אביב - יפו,5000,288,302,3,299
תל אביב - יפו,5000,289,431,3,428
תל אביב - יפו,5000,290,415,2,413
תל אביב - יפו,5000,291,489,3,486
תל אביב - יפו,5000,292,382,1,381
תל אביב - יפו,5000,293,470,1,469
תל אביב - יפו,5000,294,430,5,425
תל אביב - יפו,5000,295,402,0,402
תל אביב - יפו,5000,296,247,4,243
תל אביב - יפו,5000,297,468,2,466
תל אביב - יפו,5000,298,373,0,373
תל אביב - יפו,5000,299,283,2,281
תל אביב - יפו,5000,300,292,1,291
תל אביב - יפו,5000,301,409,0,409
תל אביב - יפו,5000,302,349,0,349
תל אביב - יפו,5000,303,435,2,433
תל אביב - יפו,5000,304,324,2,322
תל אביב - יפו,5000,306,391,1,390
תל אביב - יפו,5000,310,548,1,547
תל אביב - יפו,5000,311,549,2,547
תל אביב - יפו,5000,315,556,1,555
תל אביב - יפו,5000,316,385,3,382
תל אביב - יפו,5000,317,525,3,522
תל אביב - יפו,5000,318,389,2,387
תל אביב - יפו,5000,319,425,1,424
תל אביב - יפו,5000,323,141,1,140
תל אביב - יפו,5000,324,317,1,316
תל אביב - יפו,5000,325,320,0,320
תל אביב - יפו,5000,326,296,1,295
תל אביב - יפו,5000,327,358,3,355
תל אביב - יפו,5000,328,342,2,340
תל אביב - יפו,5000,329,349,3,346
תל אביב - יפו,5000,330,377,5,372
תל אביב - יפו,5000,331,279,1,278
תל אביב - יפו,5000,333,322,3,319
תל אביב - יפו,5000,334,288,1,287
תל אביב - יפו,5000,335,392,2,390
תל אביב - יפו,5000,336,309,0,309
תל אביב - יפו,5000,337,253,0,253
תל אביב - יפו,5000,338,388,0,388
תל אביב - יפו,5000,339,348,2,346
תל אביב - יפו,5000,340,391,2,389
תל אביב - יפו,5000,341,262,4,258
תל אביב - יפו,5000,342,348,0,348
תל אביב - יפו,5000,343,287,1,286
תל אביב - יפו,5000,344,368,2,366
תל אביב - יפו,5000,345,328,1,327
תל אביב - יפו,5000,364,346,1,345
תל אביב - יפו,5000,365,275,2,273
תל אביב - יפו,5000,367,369,2,367
תל אביב - יפו,5000,368,312,0,312
תל אביב - יפו,5000,369,306,1,305
תל אביב - יפו,5000,370,441,3,438
תל אביב - יפו,5000,371,449,3,446
תל אביב - יפו,5000,372,381,0,381
תל אביב - יפו,5000,373,389,0,389
תל אביב - יפו,5000,374,288,3,285
תל אביב - יפו,5000,375,418,0,418
תל אביב - יפו,5000,376,410,2,408
תל אביב - יפו,5000,378,392,0,392
תל אביב - יפו,5000,379,334,4,330
תל אביב - יפו,5000,380,444,2,442
תל אביב - יפו,5000,382,437,3,434
תל אביב - יפו,5000,383,329,2,327
תל אביב - יפו,5000,384,369,0,369
תל אביב - יפו,5000,386,497,1,496
תל אביב - יפו,5000,387,435,1,434
תל אביב - יפו,5000,388,411,3,408
תל אביב - יפו,5000,390,422,2,420
תל אביב - יפו,5000,391,401,1,400
תל אביב - יפו,5000,392,429,1,428
תל אביב - יפו,5000,393,361,0,361
תל אביב - יפו,5000,394,456,0,456
תל אביב - יפו,5000,395,504,2,502
תל אביב - יפו,5000,396,469,0,469
תל אביב - יפו,5000,397,485,1,484
תל אביב - יפו,5000,398,482,2,480
תל אביב - יפו,5000,399,522,0,522
תל אביב - יפו,5000,400,415,2,413
תל אביב - יפו,5000,401,390,4,386
תל אביב - יפו,5000,426,378,2,376
תל אביב - יפו,5000,427,370,2,368
תל אביב - יפו,5000,428,395,3,392
תל אביב - יפו,5000,429,505,2,503
תל אביב - יפו,5000,430,376,2,374
תל אביב - יפו,5000,431,305,2,303
תל אביב - יפו,5000,431,237,3,234
תל אביב - יפו,5000,432,346,1,345
תל אביב - יפו,5000,434,423,2,421
תל אביב - יפו,5000,435,400,3,397
תל אביב - יפו,5000,436,294,2,292
תל אביב - יפו,5000,437,433,0,433
תל אביב - יפו,5000,438,403,0,403
תל אביב - יפו,5000,439,462,2,460
תל אביב - יפו,5000,440,451,1,450
תל אביב - יפו,5000,441,511,0,511
תל אביב - יפו,5000,442,348,3,345
תל אביב - יפו,5000,443,458,5,453
תל אביב - יפו,5000,444,509,2,507
תל אביב - יפו,5000,445,451,1,450
תל אביב - יפו,5000,446,326,0,326
תל אביב - יפו,5000,447,299,1,298
תל אביב - יפו,5000,448,329,0,329
תל אביב - יפו,5000,449,375,1,374
תל אביב - יפו,5000,451,297,0,297
תל אביב - יפו,5000,452,311,3,308
תל אביב - יפו,5000,453,204,0,204
תל אביב - יפו,5000,454,296,1,295
תל אביב - יפו,5000,455,159,1,158
תל אביב - יפו,5000,456,203,2,201
תל אביב - יפו,5000,457,274,0,274
תל אביב - יפו,5000,458,355,1,354
תל אביב - יפו,5000,472,266,1,265
תל אביב - יפו,5000,473,88,0,88
תל אביב - יפו,5000,474,443,4,439
תל אביב - יפו,5000,475,390,1,389
תל אביב - יפו,5000,476,282,2,280
תל אביב - יפו,5000,477,340,0,340
תל אביב - יפו,5000,478,353,0,353
תל אביב - יפו,5000,480,380,3,377
תל אביב - יפו,5000,481,338,2,336
תל אביב - יפו,5000,482,334,2,332
תל אביב - יפו,5000,483,402,0,402
תל אביב - יפו,5000,487,306,2,304
תל אביב - יפו,5000,488,288,1,287
תל אביב - יפו,5000,491,419,0,419
תל אביב - יפו,5000,492,407,1,406
תל אביב - יפו,5000,494,264,2,262
תל אביב - יפו,5000,494,217,0,217
תל אביב - יפו,5000,495,271,2,269
תל אביב - יפו,5000,496,497,4,493
תל אביב - יפו,5000,498,375,0,375
תל אביב - יפו,5000,499,402,1,401
תל אביב - יפו,5000,501,396,1,395
תל אביב - יפו,5000,502,169,0,169
תל אביב - יפו,5000,503,460,1,459
תל אביב - יפו,5000,504,433,3,430
תל אביב - יפו,5000,506,278,2,276
תל אביב - יפו,5000,507,303,0,303
תל אביב - יפו,5000,508,261,0,261
תל אביב - יפו,5000,509,396,0,396
תל אביב - יפו,5000,529,409,0,409
תל אביב - יפו,5000,533,386,1,385
תל אביב - יפו,5000,534,467,5,462
תל אביב - יפו,5000,535,336,1,335
תל אביב - יפו,5000,546,301,0,301
תל אביב - יפו,5000,547,231,1,230
תל אביב - יפו,5000,548,470,5,465
תל אביב - יפו,5000,569,359,2,357
תל אביב - יפו,5000,570,267,0,267
תל אביב - יפו,5000,571,393,2,391
תל אביב - יפו,5000,572,345,4,341
תל אביב - יפו,5000,573,403,2,401
תל אביב - יפו,5000,574,273,2,271
תל אביב - יפו,5000,575,504,5,499
תל אביב - יפו,5000,576,451,0,451
תל אביב - יפו,5000,577,393,5,388
תל אביב - יפו,5000,578,400,1,399
תל אביב - יפו,5000,579,354,0,354
תל אביב - יפו,5000,580,335,4,331
תל אביב - יפו,5000,581,361,2,359
תל אביב - יפו,5000,582,286,5,281
תל אביב - יפו,5000,585,326,0,326
תל אביב - יפו,5000,586,266,4,262
תל אביב - יפו,5000,587,129,2,127
תל אביב - יפו,5000,588,105,2,103
תל אביב - יפו,5000,592,236,8,228
תל אביב - יפו,5000,600,501,0,501
תל אביב - יפו,5000,601,591,3,588
תל אביב - יפו,5000,611,465,0,465
תל אביב - יפו,5000,612,479,1,478
תל אביב - יפו,5000,613,455,0,455
תל אביב - יפו,5000,614,405,0,405
תל אביב - יפו,5000,616,311,0,311
תל אביב - יפו,5000,618,289,1,288
תל אביב - יפו,5000,619,445,1,444
תל אביב - יפו,5000,620,323,2,321
תל אביב - יפו,5000,621,435,3,432
תל אביב - יפו,5000,622,258,2,256
תל אביב - יפו,5000,632,501,1,500
תל אביב - יפו,5000,634,505,3,502
תל אביב - יפו,5000,635,482,0,482
תל אביב - יפו,5000,636,471,1,470
תל אביב - יפו,5000,637,449,3,446
תל אביב - יפו,5000,638,545,1,544
תל אביב - יפו,5000,639,342,0,342
תל אביב - יפו,5000,640,534,1,533
תל אביב - יפו,5000,641,516,3,513
תל אביב - יפו,5000,642,422,6,416
תל אביב - יפו,5000,643,339,2,337
תל אביב - יפו,5000,644,438,0,438
תל אביב - יפו,5000,645,413,0,413
תל אביב - יפו,5000,646,438,3,435
תל אביב - יפו,5000,647,537,3,534
תל אביב - יפו,5000,648,475,1,474
תל אביב - יפו,5000,649,426,3,423
תל אביב - יפו,5000,650,411,2,409
תל אביב - יפו,5000,661,284,3,281
תל אביב - יפו,5000,662,466,6,460
תל אביב - יפו,5000,663,233,1,232
תל אביב - יפו,5000,664,340,1,339
תל אביב - יפו,5000,665,481,4,477
תל אביב - יפו,5000,666,525,3,522
תל אביב - יפו,5000,667,415,5,410
תל אביב - יפו,5000,668,370,1,369
תל אביב - יפו,5000,669,249,2,247
תל אביב - יפו,5000,670,539,11,528
תל אביב - יפו,5000,671,329,3,326
תל אביב - יפו,5000,672,360,0,360
תל אביב - יפו,5000,673,403,2,401
תל אביב - יפו,5000,674,382,4,378
תל אביב - יפו,5000,675,365,2,363
תל אביב - יפו,5000,676,293,2,291
תל אביב - יפו,5000,677,295,4,291
תל אביב - יפו,5000,678,321,8,313
תל אביב - יפו,5000,679,430,6,424
תל אביב - יפו,5000,680,337,1,336
תל אביב - יפו,5000,681,358,8,350
תל אביב - יפו,5000,682,472,9,463
תל אביב - יפו,5000,683,446,2,444
תל אביב - יפו,5000,684,443,4,439
תל אביב - יפו,5000,685,455,1,454
תל אביב - יפו,5000,686,421,7,414
תל אביב - יפו,5000,687,423,2,421
תל אביב - יפו,5000,688,356,3,353
תל אביב - יפו,5000,689,297,1,296
תל אביב - יפו,5000,690,449,5,444
תל אביב - יפו,5000,691,411,2,409
תל אביב - יפו,5000,692,410,1,409
תל אביב - יפו,5000,693,440,3,437
תל אביב - יפו,5000,694,453,1,452
תל אביב - יפו,5000,695,408,6,402
תל אביב - יפו,5000,697,333,1,332
תל אביב - יפו,5000,698,281,4,277
תל אביב - יפו,5000,701,287,5,282
תל אביב - יפו,5000,702,408,3,405
תל אביב - יפו,5000,703,301,8,293
תל אביב - יפו,5000,704,412,3,409
תל אביב - יפו,5000,705,464,5,459
תל אביב - יפו,5000,706,292,4,288
תל אביב - יפו,5000,707,307,7,300
תל אביב - יפו,5000,708,408,2,406
תל אביב - יפו,5000,709,299,0,299
תל אביב - יפו,5000,710,353,1,352
תל אביב - יפו,5000,711,377,2,375
תל אביב - יפו,5000,712,261,2,259
תל אביב - יפו,5000,713,396,5,391
תל אביב - יפו,5000,714,331,3,328
תל אביב - יפו,5000,715,427,1,426
תל אביב - יפו,5000,716,367,2,365
תל אביב - יפו,5000,717,406,8,398
תל אביב - יפו,5000,718,378,2,376
תל אביב - יפו,5000,719,391,1,390
תל אביב - יפו,5000,720,421,0,421
תל אביב - יפו,5000,721,343,9,334
תל אביב - יפו,5000,722,215,1,214
תל אביב - יפו,5000,723,279,4,275
תל אביב - יפו,5000,724,469,9,460
תל אביב - יפו,5000,725,378,3,375
תל אביב - יפו,5000,726,446,8,438
תל אביב - יפו,5000,727,401,2,399
תל אביב - יפו,5000,728,381,4,377
תל אביב - יפו,5000,729,416,5,411
תל אביב - יפו,5000,730,370,6,364
תל אביב - יפו,5000,731,417,6,411
תל אביב - יפו,5000,732,312,4,308
תל אביב - יפו,5000,733,330,5,325
תל אביב - יפו,5000,734,337,11,326
תל אביב - יפו,5000,735,386,7,379
תל אביב - יפו,5000,736,355,5,350
תל אביב - יפו,5000,737,412,7,405
תל אביב - יפו,5000,738,441,23,418
תל אביב - יפו,5000,739,364,5,359
תל אביב - יפו,5000,740,314,8,306
תל אביב - יפו,5000,741,443,13,430
תל אביב - יפו,5000,742,250,4,246
תל אביב - יפו,5000,743,512,5,507
תל אביב - יפו,5000,744,247,7,240
תל אביב - יפו,5000,745,228,4,224
תל אביב - יפו,5000,746,438,8,430
תל אביב - יפו,5000,747,312,1,311
תל אביב - יפו,5000,748,385,4,381
תל אביב - יפו,5000,749,251,4,247
תל אביב - יפו,5000,750,488,15,473
תל אביב - יפו,5000,751,462,5,457
תל אביב - יפו,5000,752,238,8,230
תל אביב - יפו,5000,753,268,7,261
תל אביב - יפו,5000,754,495,9,486
תל אביב - יפו,5000,755,237,3,234
תל אביב - יפו,5000,756,322,3,319
תל אביב - יפו,5000,757,204,1,203
תל אביב - יפו,5000,758,406,4,402
תל אביב - יפו,5000,759,406,5,401
תל אביב - יפו,5000,760,488,2,486
תל אביב - יפו,5000,761,318,5,313
תל אביב - יפו,5000,762,397,1,396
תל אביב - יפו,5000,763,313,8,305
תל אביב - יפו,5000,764,250,6,244
תל אביב - יפו,5000,765,351,6,345
תל אביב - יפו,5000,766,203,8,195
תל אביב - יפו,5000,770,355,6,349
תל אביב - יפו,5000,772,434,7,427
תל אביב - יפו,5000,773,374,7,367
תל אביב - יפו,5000,774,453,6,447
תל אביב - יפו,5000,775,407,2,405
תל אביב - יפו,5000,776,331,1,330
תל אביב - יפו,5000,777,372,10,362
תל אביב - יפו,5000,778,405,5,400
תל אביב - יפו,5000,780,366,8,358
תל אביב - יפו,5000,781,400,7,393
תל אביב - יפו,5000,782,443,8,435
תל אביב - יפו,5000,783,363,6,357
תל אביב - יפו,5000,784,303,3,300
תל אביב - יפו,5000,785,396,4,392
תל אביב - יפו,5000,786,365,4,361
תל אביב - יפו,5000,787,404,5,399
תל אביב - יפו,5000,788,305,9,296
תל אביב - יפו,5000,789,503,8,495
תל אביב - יפו,5000,790,262,4,258
תל אביב - יפו,5000,791,336,3,333
תל אביב - יפו,5000,792,324,4,320
תל אביב - יפו,5000,793,415,5,410
תל אביב - יפו,5000,795,172,3,169
תל אביב - יפו,5000,797,147,2,145
תל אביב - יפו,5000,800,256,4,252
תל אביב - יפו,5000,821,421,1,420
תל אביב - יפו,5000,822,500,4,496
תל אביב - יפו,5000,825,295,2,293
תל אביב - יפו,5000,826,261,4,257
תל אביב - יפו,5000,827,245,2,243
תל אביב - יפו,5000,828,382,0,382
תל אביב - יפו,5000,835,495,4,491
תל אביב - יפו,5000,836,288,3,285
תל אביב - יפו,5000,837,359,3,356
תל אביב - יפו,5000,838,400,5,395
תל אביב - יפו,5000,839,447,10,437
תל אביב - יפו,5000,840,317,7,310
תל אביב - יפו,5000,841,375,6,369
תל אביב - יפו,5000,842,478,9,469
תל אביב - יפו,5000,843,367,4,363
תל אביב - יפו,5000,844,307,6,301
תל אביב - יפו,5000,845,337,3,334
תל אביב - יפו,5000,846,400,5,395
תל אביב - יפו,5000,847,338,6,332
תל אביב - יפו,5000,848,326,4,322
תל אביב - יפו,5000,849,379,8,371
תל אביב - יפו,5000,850,336,6,330
תל אביב - יפו,5000,851,302,4,298
תל אביב - יפו,5000,852,426,37,389
תל אביב - יפו,5000,853,230,4,226
תל אביב - יפו,5000,854,362,2,360
תל אביב - יפו,5000,855,460,10,450
תל אביב - יפו,5000,856,283,3,280
תל אביב - יפו,5000,857,343,14,329
תל אביב - יפו,5000,858,302,12,290
תל אביב - יפו,5000,859,323,10,313
תל אביב - יפו,5000,860,383,2,381
תל אביב - יפו,5000,861,265,13,252
תל אביב - יפו,5000,862,372,4,368
תל אביב - יפו,5000,863,326,6,320
תל אביב - יפו,5000,865,367,15,352
תל אביב - יפו,5000,866,255,6,249
תל אביב - יפו,5000,869,254,3,251
תל אביב - יפו,5000,870,234,3,231
תל אביב - יפו,5000,871,284,6,278
תל אביב - יפו,5000,872,322,5,317
תל אביב - יפו,5000,873,391,3,388
תל אביב - יפו,5000,874,277,3,274
תל אביב - יפו,5000,875,318,1,317
תל אביב - יפו,5000,876,418,2,416
תל אביב - יפו,5000,877,421,7,414
תל אביב - יפו,5000,878,424,4,420
תל אביב - יפו,5000,879,349,7,342
תל אביב - יפו,5000,880,429,4,425
תל אביב - יפו,5000,881,338,5,333
תל אביב - יפו,5000,882,309,3,306
תל אביב - יפו,5000,884,408,4,404
תל אביב - יפו,5000,885,442,4,438
תל אביב - יפו,5000,886,387,3,384
תל אביב - יפו,5000,887,352,7,345
תל אביב - יפו,5000,888,368,0,368
תל אביב - יפו,5000,889,130,2,128
תל אביב - יפו,5000,890,323,3,320
תל אביב - יפו,5000,891,444,4,440
תל אביב - יפו,5000,892,491,1,490
תל אביב - יפו,5000,893,377,4,373
תל אביב - יפו,5000,894,334,4,330
תל אביב - יפו,5000,895,290,2,288
תל אביב - יפו,5000,896,212,7,205
תל אביב - יפו,5000,897,345,3,342
תל אביב - יפו,5000,916,226,2,224
תל אביב - יפו,5000,918,372,5,367
תל אביב - יפו,5000,919,429,1,428
תל אביב - יפו,5000,923,394,8,386
תל אביב - יפו,5000,925,358,4,354
תל אביב - יפו,5000,926,443,2,441
תל אביב - יפו,5000,927,417,10,407
תל אביב - יפו,5000,934,371,0,371
תל אביב - יפו,5000,935,489,12,477
תל אביב - יפו,5000,950,254,4,250
תל אביב - יפו,5000,952,229,3,226
תל אביב - יפו,5000,954,137,0,137
תל אביב - יפו,5000,956,581,0,581
תל אביב - יפו,5000,960,492,0,492
תל אביב - יפו,5000,962,259,1,258
תל אביב - יפו,5000,963,183,3,180
תל אביב - יפו,5000,965,176,1,175
תל אביב - יפו,5000,965,101,1,100
תל אביב - יפו,5000,967,564,6,558
תל אביב - יפו,5000,968,554,0,554
תל אביב - יפו,5000,970,179,1,178
תל אביב - יפו,5000,990,56,0,56
תל יוסף,84,1,290,1,289
תל יצחק,287,1,571,4,567
תל מונד,154,1,431,4,427
תל מונד,154,2,511,1,510
תל מונד,154,3,411,0,411
תל מונד,154,4,398,7,391
תל מונד,154,5,382,0,382
תל מונד,154,6,538,0,538
תל מונד,154,7,647,1,646
תל מונד,154,8,530,4,526
תל מונד,154,9,530,2,528
תל מונד,154,10,582,5,577
תל מונד,154,11,397,1,396
תל מונד,154,12,543,2,541
תל מונד,154,13,361,2,359
תל עדשים,103,1,613,1,612
תל קציר,719,1,201,0,201
תל שבע,1054,1,361,7,354
תל שבע,1054,2,385,8,377
תל שבע,1054,3,322,10,312
תל שבע,1054,4,358,3,355
תל שבע,1054,5,304,5,299
תל שבע,1054,6,400,6,394
תל שבע,1054,7,286,2,284
תל שבע,1054,8,316,6,310
תל שבע,1054,9,190,0,190
תל שבע,1054,10,213,0,213
תל שבע,1054,11,182,5,177
תל שבע,1054,12,343,6,337
תל תאומים,1283,1,212,0,212
תלם,3719,1,100,0,100
תלמי אליהו,1051,1,158,1,157
תלמי אלעזר,2003,1,435,2,433
"תלמי ביל""ו",2050,1,218,3,215
תלמי יוסף,1237,1,166,0,166
תלמי יחיאל,727,1,410,1,409
תלמי יפה,744,1,332,1,331
תלמים,814,1,416,2,414
תמרת,1244,1,263,1,262
תמרת,1244,2,328,0,328
תמרת,1244,3,375,2,373
תנובות,2002,1,453,1,452
תעוז,752,1,328,0,328
תפרח,709,1,418,11,407
תפרח,709,2,430,11,419
תקומה,665,1,335,4,331
תקוע,3563,1,557,1,556
תקוע,3563,2,369,1,368
תקוע,3563,3,533,0,533
תראבין א-צאנע (שב,970,1,106,0,106
תראבין א-צאנע(ישו,1346,1,60,0,60
תרום,778,1,411,2,409